LEXICON	NOUNS
borsazede	POST-NOUN	`borsazede`
davaname	POST-NOUN	`davaname`

aba	POST-NOUN	`aba`
aba	POST-NOUN	`aba`
abaza	POST-NOUN	`abaza`
abbas	POST-NOUN	`abbas`
abd	POST-NOUN	`abd`
abdest	POST-NOUN	`abdest`
abdestbozan	POST-NOUN	`abdestbozan`
abdesthane	POST-NOUN	`abdesthane`
abdiaciz	POST-NOUN	`abdiaciz`
abýkevser	POST-NOUN	`abýkevser`
abi	POST-NOUN	`abi`
abiye	POST-NOUN	`abiye`
ablatif	POST-NOUN	`ablatif`
aborjin	POST-NOUN	`aborjin`
abra	POST-NOUN	`abra`
abrakadabra	POST-NOUN	`abrakadabra`
abril	POST-NOUN	`abril`
absorbe	POST-NOUN	`absorbe`
abstraksiyonizm	POST-NOUN	`abstraksiyonizm`
acaba	POST-NOUN	`acaba`
acar	POST-NOUN	`acar`
acara	POST-NOUN	`acara`
acele	POST-NOUN	`acele`
acemborusu	POST-NOUN	`acemborusu`
acemi	POST-NOUN	`acemi`
aciz	POST-NOUN	`aciz`
acube	POST-NOUN	`acube`
acuze	POST-NOUN	`acuze`
aç	POST-NOUN	`aç`
açacak	POST-NOUN	`açacak`
açan	POST-NOUN	`açan`
açar	POST-NOUN	`açar`
açelya	POST-NOUN	`açelya`
açýk	POST-NOUN	`açýk`
açýkaðýz	POST-NOUN	`açýkaðýz`
açýkçasý	POST-NOUN	`açýkçasý`
açýklanan	POST-NOUN	`açýklanan`
açýklayan	POST-NOUN	`açýklayan`
açým	POST-NOUN	`açým`
açýölçer	POST-NOUN	`açýölçer`
açval	POST-NOUN	`açval`
ad	POST-NOUN	`ad`
ad	POST-NOUN	`ad`
adamkökü	POST-NOUN	`adamkökü`
adamotu	POST-NOUN	`adamotu`
adap	POST-NOUN	`adap`
adayavrusu	POST-NOUN	`adayavrusu`
adedimürettep	POST-NOUN	`adedimürettep`
adembaba	POST-NOUN	`adembaba`
ademelmasý	POST-NOUN	`ademelmasý`
ademimerkeziyet	POST-NOUN	`ademimerkeziyet`
adýmsayar	POST-NOUN	`adýmsayar`
adisyon	POST-NOUN	`adisyon`
aerobik	POST-NOUN	`aerobik`
aeroloji	POST-NOUN	`aeroloji`
afak	POST-NOUN	`afak`
afgan	POST-NOUN	`afgan`
afis	POST-NOUN	`afis`
aforizm	POST-NOUN	`aforizm`
afþar	POST-NOUN	`afþar`
aft	POST-NOUN	`aft`
aga	POST-NOUN	`aga`
agami	POST-NOUN	`agami`
agnostik	POST-NOUN	`agnostik`
agnozi	POST-NOUN	`agnozi`
agop	POST-NOUN	`agop`
agrega	POST-NOUN	`agrega`
agronomi	POST-NOUN	`agronomi`
aðaçdelen	POST-NOUN	`aðaçdelen`
aðýrtop	POST-NOUN	`aðýrtop`
aðýt	POST-NOUN	`aðýt`
aðýz	POST-NOUN	`aðýz`
aðýz	POST-NOUN	`aðýz`
aðýzotu	POST-NOUN	`aðýzotu`
aðlantý	POST-NOUN	`aðlantý`
aðraz	POST-NOUN	`aðraz`
ahbap	POST-NOUN	`ahbap`
ahcar	POST-NOUN	`ahcar`
ahfat	POST-NOUN	`ahfat`
ahfeþ	POST-NOUN	`ahfeþ`
ahi	POST-NOUN	`ahi`
ahi	POST-NOUN	`ahi`
ahiret	POST-NOUN	`ahiret`
ahit	POST-NOUN	`ahit`
ahiz	POST-NOUN	`ahiz`
ahlaf	POST-NOUN	`ahlaf`
ahlak	POST-NOUN	`ahlak`
ahlakiyat	POST-NOUN	`ahlakiyat`
ahlatýerbaa	POST-NOUN	`ahlatýerbaa`
ahmakýslatan	POST-NOUN	`ahmakýslatan`
ahu	POST-NOUN	`ahu`
ahuvah	POST-NOUN	`ahuvah`
ahzüita	POST-NOUN	`ahzüita`
ahzükabz	POST-NOUN	`ahzükabz`
ajite	POST-NOUN	`ajite`
ak	POST-NOUN	`ak`
aka	POST-NOUN	`aka`
akabe	POST-NOUN	`akabe`
akait	POST-NOUN	`akait`
akarsu	POST-NOUN	`akarsu`
akbakla	POST-NOUN	`akbakla`
akbuðday	POST-NOUN	`akbuðday`
akdut	POST-NOUN	`akdut`
akemi	POST-NOUN	`akemi`
akýl	POST-NOUN	`akýl`
akýmölçer	POST-NOUN	`akýmölçer`
akýnkayasý	POST-NOUN	`akýnkayasý`
akýntýölçer	POST-NOUN	`akýntýölçer`
akis	POST-NOUN	`akis`
akit	POST-NOUN	`akit`
akkaraman	POST-NOUN	`akkaraman`
aklevrek	POST-NOUN	`aklevrek`
aklýevvel	POST-NOUN	`aklýevvel`
akmaz	POST-NOUN	`akmaz`
akne	POST-NOUN	`akne`
akompanyatör	POST-NOUN	`akompanyatör`
akor	POST-NOUN	`akor`
akordiyon	POST-NOUN	`akordiyon`
akort	POST-NOUN	`akort`
akpelin	POST-NOUN	`akpelin`
akreditasyon	POST-NOUN	`akreditasyon`
akrep	POST-NOUN	`akrep`
akrep	POST-NOUN	`akrep`
akrep	POST-NOUN	`akrep`
akronim	POST-NOUN	`akronim`
akropol	POST-NOUN	`akropol`
akse	POST-NOUN	`akse`
akselerometre	POST-NOUN	`akselerometre`
aksiyoner	POST-NOUN	`aksiyoner`
aksoðan	POST-NOUN	`aksoðan`
aksona	POST-NOUN	`aksona`
aksöðüt	POST-NOUN	`aksöðüt`
aksungur	POST-NOUN	`aksungur`
akþamsefasý	POST-NOUN	`akþamsefasý`
aktariye	POST-NOUN	`aktariye`
aktinoloji	POST-NOUN	`aktinoloji`
aktüer	POST-NOUN	`aktüer`
akva	POST-NOUN	`akva`
alacakarga	POST-NOUN	`alacakarga`
alacasansar	POST-NOUN	`alacasansar`
alakart	POST-NOUN	`alakart`
alametifarika	POST-NOUN	`alametifarika`
alaza	POST-NOUN	`alaza`
alçýpan	POST-NOUN	`alçýpan`
aldehit	POST-NOUN	`aldehit`
alengir	POST-NOUN	`alengir`
alerjen	POST-NOUN	`alerjen`
alevi	POST-NOUN	`alevi`
alfaterapi	POST-NOUN	`alfaterapi`
alfenit	POST-NOUN	`alfenit`
alg	POST-NOUN	`alg`
alýn	POST-NOUN	`alýn`
alkalimetre	POST-NOUN	`alkalimetre`
alkaloit	POST-NOUN	`alkaloit`
alkan	POST-NOUN	`alkan`
alkarýsý	POST-NOUN	`alkarýsý`
alkol	POST-NOUN	`alkol`
alkolmetre	POST-NOUN	`alkolmetre`
allah	POST-NOUN	`allah`
allah	POST-NOUN	`allah`
allahuteala	POST-NOUN	`allahuteala`
alogami	POST-NOUN	`alogami`
alperen	POST-NOUN	`alperen`
alpinist	POST-NOUN	`alpinist`
alpinizm	POST-NOUN	`alpinizm`
alpyýldýzý	POST-NOUN	`alpyýldýzý`
alt	POST-NOUN	`alt`
altayist	POST-NOUN	`altayist`
altayistik	POST-NOUN	`altayistik`
altý	POST-NOUN	`altý`
altýkardeþ	POST-NOUN	`altýkardeþ`
altýn	POST-NOUN	`altýn`
altimetre	POST-NOUN	`altimetre`
alümina	POST-NOUN	`alümina`
alüminyum	POST-NOUN	`alüminyum`
alveol	POST-NOUN	`alveol`
alyan	POST-NOUN	`alyan`
amalgam	POST-NOUN	`amalgam`
amalierbaa	POST-NOUN	`amalierbaa`
amasya	POST-NOUN	`amasya`
ambiyans	POST-NOUN	`ambiyans`
amenajman	POST-NOUN	`amenajman`
amentü	POST-NOUN	`amentü`
amentü	POST-NOUN	`amentü`
amerikanist	POST-NOUN	`amerikanist`
amerikanizm	POST-NOUN	`amerikanizm`
amerikansý	POST-NOUN	`amerikansý`
amerikaüzümü	POST-NOUN	`amerikaüzümü`
amfibol	POST-NOUN	`amfibol`
amfizem	POST-NOUN	`amfizem`
aminoasit	POST-NOUN	`aminoasit`
amip	POST-NOUN	`amip`
amiral	POST-NOUN	`amiral`
amiriita	POST-NOUN	`amiriita`
amit	POST-NOUN	`amit`
amniyon	POST-NOUN	`amniyon`
amor	POST-NOUN	`amor`
amor	POST-NOUN	`amor`
ampermetre	POST-NOUN	`ampermetre`
ampul	POST-NOUN	`ampul`
ampütasyon	POST-NOUN	`ampütasyon`
amudufýkari	POST-NOUN	`amudufýkari`
amut	POST-NOUN	`amut`
ana	POST-NOUN	`ana`
anagram	POST-NOUN	`anagram`
anakonda	POST-NOUN	`anakonda`
anakronizm	POST-NOUN	`anakronizm`
analizör	POST-NOUN	`analizör`
analoji	POST-NOUN	`analoji`
anamnez	POST-NOUN	`anamnez`
anamnezi	POST-NOUN	`anamnezi`
anatomist	POST-NOUN	`anatomist`
anavaþya	POST-NOUN	`anavaþya`
anchorman	POST-NOUN	`anchorman`
andemi	POST-NOUN	`andemi`
andoskop	POST-NOUN	`andoskop`
andoskopi	POST-NOUN	`andoskopi`
anemometre	POST-NOUN	`anemometre`
aneroit	POST-NOUN	`aneroit`
anestezist	POST-NOUN	`anestezist`
anesteziyoloji	POST-NOUN	`anesteziyoloji`
anfi	POST-NOUN	`anfi`
anfiteatr	POST-NOUN	`anfiteatr`
anglikan	POST-NOUN	`anglikan`
anglikanizm	POST-NOUN	`anglikanizm`
anglofil	POST-NOUN	`anglofil`
anglosakson	POST-NOUN	`anglosakson`
angut	POST-NOUN	`angut`
anýrtý	POST-NOUN	`anýrtý`
anýtkabir	POST-NOUN	`anýtkabir`
anýtkabir	POST-NOUN	`anýtkabir`
animasyon	POST-NOUN	`animasyon`
animatör	POST-NOUN	`animatör`
anjiyo	POST-NOUN	`anjiyo`
anjiyografi	POST-NOUN	`anjiyografi`
anjiyoloji	POST-NOUN	`anjiyoloji`
anka	POST-NOUN	`anka`
anonsör	POST-NOUN	`anonsör`
anorak	POST-NOUN	`anorak`
anorganik	POST-NOUN	`anorganik`
anot	POST-NOUN	`anot`
ansambl	POST-NOUN	`ansambl`
ansefalit	POST-NOUN	`ansefalit`
ansiklopedist	POST-NOUN	`ansiklopedist`
ant	POST-NOUN	`ant`
antagonizm	POST-NOUN	`antagonizm`
antarktika	POST-NOUN	`antarktika`
antefleksiyon	POST-NOUN	`antefleksiyon`
anterograf	POST-NOUN	`anterograf`
anterosel	POST-NOUN	`anterosel`
anterostomi	POST-NOUN	`anterostomi`
antialerjik	POST-NOUN	`antialerjik`
antidot	POST-NOUN	`antidot`
antiemperyalizm	POST-NOUN	`antiemperyalizm`
antikapitalizm	POST-NOUN	`antikapitalizm`
antikomünizm	POST-NOUN	`antikomünizm`
antioksidan	POST-NOUN	`antioksidan`
antipropaganda	POST-NOUN	`antipropaganda`
antisemitik	POST-NOUN	`antisemitik`
antisemitizm	POST-NOUN	`antisemitizm`
antitoksik	POST-NOUN	`antitoksik`
antoloji	POST-NOUN	`antoloji`
antrikot	POST-NOUN	`antrikot`
antropoit	POST-NOUN	`antropoit`
antropolog	POST-NOUN	`antropolog`
antropoloji	POST-NOUN	`antropoloji`
antroponim	POST-NOUN	`antroponim`
antroposantrizm	POST-NOUN	`antroposantrizm`
anüri	POST-NOUN	`anüri`
aparey	POST-NOUN	`aparey`
aparkat	POST-NOUN	`aparkat`
apel	POST-NOUN	`apel`
aplike	POST-NOUN	`aplike`
apokrif	POST-NOUN	`apokrif`
apostrof	POST-NOUN	`apostrof`
apoþi	POST-NOUN	`apoþi`
apotr	POST-NOUN	`apotr`
ara	POST-NOUN	`ara`
arabankürdi	POST-NOUN	`arabankürdi`
arabaþý	POST-NOUN	`arabaþý`
arabesk	POST-NOUN	`arabesk`
arabi	POST-NOUN	`arabi`
arabist	POST-NOUN	`arabist`
arabistik	POST-NOUN	`arabistik`
arabizasyon	POST-NOUN	`arabizasyon`
arafat	POST-NOUN	`arafat`
arakiye	POST-NOUN	`arakiye`
aranje	POST-NOUN	`aranje`
aranjör	POST-NOUN	`aranjör`
arantý	POST-NOUN	`arantý`
arap	POST-NOUN	`arap`
arap	POST-NOUN	`arap`
arap	POST-NOUN	`arap`
arasat	POST-NOUN	`arasat`
araþit	POST-NOUN	`araþit`
araþtýrý	POST-NOUN	`araþtýrý`
araþtýrman	POST-NOUN	`araþtýrman`
arayüz	POST-NOUN	`arayüz`
arbalet	POST-NOUN	`arbalet`
arboretum	POST-NOUN	`arboretum`
ardak	POST-NOUN	`ardak`
arefe	POST-NOUN	`arefe`
areometre	POST-NOUN	`areometre`
argýt	POST-NOUN	`argýt`
argüman	POST-NOUN	`argüman`
arýkovaný	POST-NOUN	`arýkovaný`
arýtýmevi	POST-NOUN	`arýtýmevi`
ari	POST-NOUN	`ari`
aria	POST-NOUN	`aria`
arioso	POST-NOUN	`arioso`
ariza	POST-NOUN	`ariza`
arjantin	POST-NOUN	`arjantin`
ark	POST-NOUN	`ark`
arka	POST-NOUN	`arka`
arkalýç	POST-NOUN	`arkalýç`
arkeolog	POST-NOUN	`arkeolog`
arkeoloji	POST-NOUN	`arkeoloji`
arketip	POST-NOUN	`arketip`
arkýt	POST-NOUN	`arkýt`
armonik	POST-NOUN	`armonik`
armut	POST-NOUN	`armut`
arnavutciðeri	POST-NOUN	`arnavutciðeri`
arp	POST-NOUN	`arp`
arpaðan	POST-NOUN	`arpaðan`
arþýala	POST-NOUN	`arþýala`
arþidük	POST-NOUN	`arþidük`
arþidüþes	POST-NOUN	`arþidüþes`
art	POST-NOUN	`art`
artý	POST-NOUN	`artý`
artýk	POST-NOUN	`artýk`
artýn	POST-NOUN	`artýn`
artikülasyon	POST-NOUN	`artikülasyon`
artmak	POST-NOUN	`artmak`
artrit	POST-NOUN	`artrit`
artroz	POST-NOUN	`artroz`
aryanizm	POST-NOUN	`aryanizm`
arziyat	POST-NOUN	`arziyat`
arzuhal	POST-NOUN	`arzuhal`
asap	POST-NOUN	`asap`
asarýatika	POST-NOUN	`asarýatika`
aselbent	POST-NOUN	`aselbent`
asesbaþý	POST-NOUN	`asesbaþý`
asetat	POST-NOUN	`asetat`
asfaltit	POST-NOUN	`asfaltit`
asýl	POST-NOUN	`asýl`
asým	POST-NOUN	`asým`
asýr	IsimZaman	`asýr`
asidimetre	POST-NOUN	`asidimetre`
asil	POST-NOUN	`asil`
asimetri	POST-NOUN	`asimetri`
asimile	POST-NOUN	`asimile`
asist	POST-NOUN	`asist`
asit	POST-NOUN	`asit`
ask	POST-NOUN	`ask`
aslanaðzý	POST-NOUN	`aslanaðzý`
aslankulaðý	POST-NOUN	`aslankulaðý`
aslankuyruðu	POST-NOUN	`aslankuyruðu`
asliye	POST-NOUN	`asliye`
asonans	POST-NOUN	`asonans`
asparagas	POST-NOUN	`asparagas`
asrýsaadet	POST-NOUN	`asrýsaadet`
assolist	POST-NOUN	`assolist`
astarya	POST-NOUN	`astarya`
astik	POST-NOUN	`astik`
astrolog	POST-NOUN	`astrolog`
astroloji	POST-NOUN	`astroloji`
asyön	POST-NOUN	`asyön`
aþari	POST-NOUN	`aþari`
aþerat	POST-NOUN	`aþerat`
aþevi	POST-NOUN	`aþevi`
aþýným	POST-NOUN	`aþýným`
aþýntý	POST-NOUN	`aþýntý`
aþýrýntý	POST-NOUN	`aþýrýntý`
aþýrmasyon	POST-NOUN	`aþýrmasyon`
aþir	POST-NOUN	`aþir`
aþiyan	POST-NOUN	`aþiyan`
aþk	POST-NOUN	`aþk`
aþkmerdiveni	POST-NOUN	`aþkmerdiveni`
atari	POST-NOUN	`atari`
atasözü	POST-NOUN	`atasözü`
ataþ	POST-NOUN	`ataþ`
atbalýðý	POST-NOUN	`atbalýðý`
atbaþý	POST-NOUN	`atbaþý`
atelye	POST-NOUN	`atelye`
ateþbaz	POST-NOUN	`ateþbaz`
atgözlüðü	POST-NOUN	`atgözlüðü`
atýf	POST-NOUN	`atýf`
atkuyruðu	POST-NOUN	`atkuyruðu`
atol	POST-NOUN	`atol`
attar	POST-NOUN	`attar`
aval	POST-NOUN	`aval`
avane	POST-NOUN	`avane`
avar	POST-NOUN	`avar`
avarýz	POST-NOUN	`avarýz`
avokado	POST-NOUN	`avokado`
avrat	POST-NOUN	`avrat`
avret	POST-NOUN	`avret`
avrovil	POST-NOUN	`avrovil`
avþar	POST-NOUN	`avþar`
avurt	POST-NOUN	`avurt`
ayakaltý	POST-NOUN	`ayakaltý`
ayakçak	POST-NOUN	`ayakçak`
ayaküstü	POST-NOUN	`ayaküstü`
ayal	POST-NOUN	`ayal`
ayartý	POST-NOUN	`ayartý`
aybaþý	POST-NOUN	`aybaþý`
ayçiçeði	POST-NOUN	`ayçiçeði`
ayevi	POST-NOUN	`ayevi`
ayýbacaðý	POST-NOUN	`ayýbacaðý`
ayýkulaðý	POST-NOUN	`ayýkulaðý`
ayýltý	POST-NOUN	`ayýltý`
ayýn	POST-NOUN	`ayýn`
ayýp	POST-NOUN	`ayýp`
ayýt	POST-NOUN	`ayýt`
ayinicem	POST-NOUN	`ayinicem`
ayn	POST-NOUN	`ayn`
aynaz	POST-NOUN	`aynaz`
aynaz	POST-NOUN	`aynaz`
ayný	POST-NOUN	`ayný`
aynþtaynyum	POST-NOUN	`aynþtaynyum`
aysfilt	POST-NOUN	`aysfilt`
ayvadana	POST-NOUN	`ayvadana`
ayvaz	POST-NOUN	`ayvaz`
az	POST-NOUN	`az`
azap	POST-NOUN	`azap`
azap	POST-NOUN	`azap`
azat	POST-NOUN	`azat`
azelya	POST-NOUN	`azelya`
azeri	POST-NOUN	`azeri`
azil	POST-NOUN	`azil`
azim	POST-NOUN	`azim`
azimet	POST-NOUN	`azimet`
azit	POST-NOUN	`azit`
azize	POST-NOUN	`azize`
aziziye	POST-NOUN	`aziziye`
azmak	POST-NOUN	`azmak`
azmankaya	POST-NOUN	`azmankaya`
azol	POST-NOUN	`azol`
azonal	POST-NOUN	`azonal`
azotometre	POST-NOUN	`azotometre`
azotölçer	POST-NOUN	`azotölçer`
azrail	POST-NOUN	`azrail`
azvay	POST-NOUN	`azvay`
babaevi	POST-NOUN	`babaevi`
babai	POST-NOUN	`babai`
babayiðit	POST-NOUN	`babayiðit`
babi	POST-NOUN	`babi`
bacabaþý	POST-NOUN	`bacabaþý`
bacakkalemi	POST-NOUN	`bacakkalemi`
bacakkýran	POST-NOUN	`bacakkýran`
baç	POST-NOUN	`baç`
bad	POST-NOUN	`bad`
badat	POST-NOUN	`badat`
badýsaba	POST-NOUN	`badýsaba`
badiye	POST-NOUN	`badiye`
badminton	POST-NOUN	`badminton`
baget	POST-NOUN	`baget`
bað	POST-NOUN	`bað`
bað	POST-NOUN	`bað`
baðda	POST-NOUN	`baðda`
baðdat	POST-NOUN	`baðdat`
baðýn	POST-NOUN	`baðýn`
baðýr	POST-NOUN	`baðýr`
baðýrdak	POST-NOUN	`baðýrdak`
baðýt	POST-NOUN	`baðýt`
baðkesen	POST-NOUN	`baðkesen`
baðlanak	POST-NOUN	`baðlanak`
baha	POST-NOUN	`baha`
bahai	POST-NOUN	`bahai`
bahariye	POST-NOUN	`bahariye`
bahir	POST-NOUN	`bahir`
bahis	POST-NOUN	`bahis`
bakalit	POST-NOUN	`bakalit`
bakýmevi	POST-NOUN	`bakýmevi`
bakýntý	POST-NOUN	`bakýntý`
bakýr	POST-NOUN	`bakýr`
bakire	POST-NOUN	`bakire`
baklaçiçeði	POST-NOUN	`baklaçiçeði`
bakteriyolog	POST-NOUN	`bakteriyolog`
bakteriyoloji	POST-NOUN	`bakteriyoloji`
bakteriyoskopi	POST-NOUN	`bakteriyoskopi`
bal	POST-NOUN	`bal`
balat	POST-NOUN	`balat`
balayý	POST-NOUN	`balayý`
balçiçeði	POST-NOUN	`balçiçeði`
baldýrpatlatan	POST-NOUN	`baldýrpatlatan`
baldo	POST-NOUN	`baldo`
balet	POST-NOUN	`balet`
balhane	POST-NOUN	`balhane`
balýkgözü	POST-NOUN	`balýkgözü`
balýksýrtý	POST-NOUN	`balýksýrtý`
balkabaðý	POST-NOUN	`balkabaðý`
balkanolog	POST-NOUN	`balkanolog`
balkanoloji	POST-NOUN	`balkanoloji`
balký	POST-NOUN	`balký`
balköpüðü	POST-NOUN	`balköpüðü`
ballýdarý	POST-NOUN	`ballýdarý`
baloncuk	POST-NOUN	`baloncuk`
balsam	POST-NOUN	`balsam`
baltýk	POST-NOUN	`baltýk`
baltrap	POST-NOUN	`baltrap`
bambu	POST-NOUN	`bambu`
bamyatarlasý	POST-NOUN	`bamyatarlasý`
banak	POST-NOUN	`banak`
bandana	POST-NOUN	`bandana`
bank	POST-NOUN	`bank`
bankamatik	POST-NOUN	`bankamatik`
bankerzede	POST-NOUN	`bankerzede`
baptist	POST-NOUN	`baptist`
barba	POST-NOUN	`barba`
barbakan	POST-NOUN	`barbakan`
barbaþý	POST-NOUN	`barbaþý`
barbekü	POST-NOUN	`barbekü`
barçak	POST-NOUN	`barçak`
bardakaltý	POST-NOUN	`bardakaltý`
bardan	POST-NOUN	`bardan`
bardo	POST-NOUN	`bardo`
baret	POST-NOUN	`baret`
baret	POST-NOUN	`baret`
bargah	POST-NOUN	`bargah`
barit	POST-NOUN	`barit`
bark	POST-NOUN	`bark`
barkarol	POST-NOUN	`barkarol`
barkod	POST-NOUN	`barkod`
barok	POST-NOUN	`barok`
barometre	POST-NOUN	`barometre`
barparalel	POST-NOUN	`barparalel`
basak	POST-NOUN	`basak`
basar	POST-NOUN	`basar`
basar	POST-NOUN	`basar`
basýmevi	POST-NOUN	`basýmevi`
basket	POST-NOUN	`basket`
bastýrak	POST-NOUN	`bastýrak`
bastýrýk	POST-NOUN	`bastýrýk`
bastýrým	POST-NOUN	`bastýrým`
basübadelmevt	POST-NOUN	`basübadelmevt`
baþaðrýsý	POST-NOUN	`baþaðrýsý`
baþakçýk	POST-NOUN	`baþakçýk`
baþaktör	POST-NOUN	`baþaktör`
baþaktris	POST-NOUN	`baþaktris`
baþaltý	POST-NOUN	`baþaltý`
baþbayi	POST-NOUN	`baþbayi`
baþdanýþman	POST-NOUN	`baþdanýþman`
baþefendi	POST-NOUN	`baþefendi`
baþeksper	POST-NOUN	`baþeksper`
baþfiyat	POST-NOUN	`baþfiyat`
baþhostes	POST-NOUN	`baþhostes`
baþýbozuk	POST-NOUN	`baþýbozuk`
baþýnda	POST-NOUN	`baþýnda`
baþkafiye	POST-NOUN	`baþkafiye`
baþkahraman	POST-NOUN	`baþkahraman`
baþkarakter	POST-NOUN	`baþkarakter`
baþkatip	POST-NOUN	`baþkatip`
baþkiþi	POST-NOUN	`baþkiþi`
baþmuallim	POST-NOUN	`baþmuallim`
baþmurakýp	POST-NOUN	`baþmurakýp`
baþmüezzin	POST-NOUN	`baþmüezzin`
baþmürettip	POST-NOUN	`baþmürettip`
baþmüsevvit	POST-NOUN	`baþmüsevvit`
baþnokta	POST-NOUN	`baþnokta`
baþoda	POST-NOUN	`baþoda`
baþrahip	POST-NOUN	`baþrahip`
baþrejisör	POST-NOUN	`baþrejisör`
baþrol	POST-NOUN	`baþrol`
baþsaðlýðý	POST-NOUN	`baþsaðlýðý`
baþtabip	POST-NOUN	`baþtabip`
baþtarda	POST-NOUN	`baþtarda`
baþyemek	POST-NOUN	`baþyemek`
baþyönetmen	POST-NOUN	`baþyönetmen`
baþyukarý	POST-NOUN	`baþyukarý`
batý	POST-NOUN	`batý`
batý	POST-NOUN	`batý`
batýni	POST-NOUN	`batýni`
batýniye	POST-NOUN	`batýniye`
batýrýk	POST-NOUN	`batýrýk`
batimetre	POST-NOUN	`batimetre`
batimetri	POST-NOUN	`batimetri`
batisfer	POST-NOUN	`batisfer`
batöz	POST-NOUN	`batöz`
battýçýktý	POST-NOUN	`battýçýktý`
bayatý	POST-NOUN	`bayatý`
bayatiaraban	POST-NOUN	`bayatiaraban`
baypas	POST-NOUN	`baypas`
bayrakaltý	POST-NOUN	`bayrakaltý`
bayrami	POST-NOUN	`bayrami`
baza	POST-NOUN	`baza`
bazofil	POST-NOUN	`bazofil`
bazofobi	POST-NOUN	`bazofobi`
beçene	POST-NOUN	`beçene`
bedayi	POST-NOUN	`bedayi`
bediiyat	POST-NOUN	`bediiyat`
bedik	POST-NOUN	`bedik`
bedir	POST-NOUN	`bedir`
bedirik	POST-NOUN	`bedirik`
bedük	POST-NOUN	`bedük`
begonvil	POST-NOUN	`begonvil`
beð	POST-NOUN	`beð`
beherglas	POST-NOUN	`beherglas`
behiþt	POST-NOUN	`behiþt`
behre	POST-NOUN	`behre`
beis	POST-NOUN	`beis`
bej	POST-NOUN	`bej`
bek	POST-NOUN	`bek`
bek	POST-NOUN	`bek`
bekar	POST-NOUN	`bekar`
bekar	POST-NOUN	`bekar`
bekarhane	POST-NOUN	`bekarhane`
bekas	POST-NOUN	`bekas`
bektaþi	POST-NOUN	`bektaþi`
bektaþikavuðu	POST-NOUN	`bektaþikavuðu`
belagat	POST-NOUN	`belagat`
belgegeçer	POST-NOUN	`belgegeçer`
belirgi	POST-NOUN	`belirgi`
belirten	POST-NOUN	`belirten`
belirtilen	POST-NOUN	`belirtilen`
belirtken	POST-NOUN	`belirtken`
belitken	POST-NOUN	`belitken`
beliye	POST-NOUN	`beliye`
belleten	POST-NOUN	`belleten`
bemol	POST-NOUN	`bemol`
benchmarking	POST-NOUN	`benchmarking`
bendegan	POST-NOUN	`bendegan`
bendehane	POST-NOUN	`bendehane`
bendezade	POST-NOUN	`bendezade`
bendir	POST-NOUN	`bendir`
benefþe	POST-NOUN	`benefþe`
beniadem	POST-NOUN	`beniadem`
benibeþer	POST-NOUN	`benibeþer`
beniz	POST-NOUN	`beniz`
bent	POST-NOUN	`bent`
benzemez	POST-NOUN	`benzemez`
benzen	POST-NOUN	`benzen`
benzer	POST-NOUN	`benzer`
benzeþen	POST-NOUN	`benzeþen`
benzol	POST-NOUN	`benzol`
beraatizimmet	POST-NOUN	`beraatizimmet`
berberi	POST-NOUN	`berberi`
berceste	POST-NOUN	`berceste`
berdel	POST-NOUN	`berdel`
berdelacuz	POST-NOUN	`berdelacuz`
bergamodi	POST-NOUN	`bergamodi`
bergüzar	POST-NOUN	`bergüzar`
beril	POST-NOUN	`beril`
berlam	POST-NOUN	`berlam`
bermuda	POST-NOUN	`bermuda`
besalet	POST-NOUN	`besalet`
beserek	POST-NOUN	`beserek`
besihane	POST-NOUN	`besihane`
beþ	POST-NOUN	`beþ`
beþamel	POST-NOUN	`beþamel`
beþer	POST-NOUN	`beþer`
beþon	POST-NOUN	`beþon`
beþtaþ	POST-NOUN	`beþtaþ`
bet	POST-NOUN	`bet`
beton	POST-NOUN	`beton`
bevvap	POST-NOUN	`bevvap`
beyaban	POST-NOUN	`beyaban`
beyaz	POST-NOUN	`beyaz`
beyaztilki	POST-NOUN	`beyaztilki`
beyin	POST-NOUN	`beyin`
beyinoraðý	POST-NOUN	`beyinoraðý`
beyit	POST-NOUN	`beyit`
beylerbeyi	POST-NOUN	`beylerbeyi`
beytülmal	POST-NOUN	`beytülmal`
beyyine	POST-NOUN	`beyyine`
beyzbol	POST-NOUN	`beyzbol`
bezen	POST-NOUN	`bezen`
bezgi	POST-NOUN	`bezgi`
bezirganbaþý	POST-NOUN	`bezirganbaþý`
bezm	POST-NOUN	`bezm`
bezzaz	POST-NOUN	`bezzaz`
býçaksýrtý	POST-NOUN	`býçaksýrtý`
býçýk	POST-NOUN	`býçýk`
býçýlgan	POST-NOUN	`býçýlgan`
býçkýevi	POST-NOUN	`býçkýevi`
býçkýhane	POST-NOUN	`býçkýhane`
býkkýntý	POST-NOUN	`býkkýntý`
býrakým	POST-NOUN	`býrakým`
býtýrak	POST-NOUN	`býtýrak`
biat	POST-NOUN	`biat`
bibliyotek	POST-NOUN	`bibliyotek`
biçenek	POST-NOUN	`biçenek`
bidat	POST-NOUN	`bidat`
bide	POST-NOUN	`bide`
bijuteri	POST-NOUN	`bijuteri`
bikir	POST-NOUN	`bikir`
bileþen	POST-NOUN	`bileþen`
bilgiç	POST-NOUN	`bilgiç`
bilgileþim	POST-NOUN	`bilgileþim`
bilgiyazar	POST-NOUN	`bilgiyazar`
bilinçaltý	POST-NOUN	`bilinçaltý`
billahi	POST-NOUN	`billahi`
billboard	POST-NOUN	`billboard`
billur	POST-NOUN	`billur`
bilsat	POST-NOUN	`bilsat`
bilyon	POST-NOUN	`bilyon`
bin	POST-NOUN	`bin`
bingi	POST-NOUN	`bingi`
binyýl	POST-NOUN	`binyýl`
bir	POST-NOUN	`bir`
birun	POST-NOUN	`birun`
biryan	POST-NOUN	`biryan`
bismillah	POST-NOUN	`bismillah`
bistro	POST-NOUN	`bistro`
bisülfat	POST-NOUN	`bisülfat`
bisülfür	POST-NOUN	`bisülfür`
biþek	POST-NOUN	`biþek`
biþi	POST-NOUN	`biþi`
bitirimhane	POST-NOUN	`bitirimhane`
bitmiþi	POST-NOUN	`bitmiþi`
bitpazarý	POST-NOUN	`bitpazarý`
biyaprak	POST-NOUN	`biyaprak`
biyoelektronik	POST-NOUN	`biyoelektronik`
biyoenerji	POST-NOUN	`biyoenerji`
biyogaz	POST-NOUN	`biyogaz`
biyograf	POST-NOUN	`biyograf`
biyokütle	POST-NOUN	`biyokütle`
biyolog	POST-NOUN	`biyolog`
biyoloji	POST-NOUN	`biyoloji`
biyomekanik	POST-NOUN	`biyomekanik`
biyometeoroloji	POST-NOUN	`biyometeoroloji`
biyomikroskop	POST-NOUN	`biyomikroskop`
biyotop	POST-NOUN	`biyotop`
biz	POST-NOUN	`biz`
biz	POST-NOUN	`biz`
blender	POST-NOUN	`blender`
bodurlaþmak	POST-NOUN	`bodurlaþmak`
bodyguard	POST-NOUN	`bodyguard`
boðasak	POST-NOUN	`boðasak`
boðmak	POST-NOUN	`boðmak`
bohriyum	POST-NOUN	`bohriyum`
bok	POST-NOUN	`bok`
bolometre	POST-NOUN	`bolometre`
bolþevik	POST-NOUN	`bolþevik`
bolþevizm	POST-NOUN	`bolþevizm`
bom	POST-NOUN	`bom`
bonmarþe	POST-NOUN	`bonmarþe`
bop	POST-NOUN	`bop`
borazancýbaþý	POST-NOUN	`borazancýbaþý`
bordo	POST-NOUN	`bordo`
bordür	POST-NOUN	`bordür`
borþ	POST-NOUN	`borþ`
boruk	POST-NOUN	`boruk`
boþnak	POST-NOUN	`boþnak`
bovling	POST-NOUN	`bovling`
boydak	POST-NOUN	`boydak`
boymul	POST-NOUN	`boymul`
boyna	POST-NOUN	`boyna`
boynueðri	POST-NOUN	`boynueðri`
boyoz	POST-NOUN	`boyoz`
boyun	POST-NOUN	`boyun`
boz	POST-NOUN	`boz`
bozahane	POST-NOUN	`bozahane`
bozayý	POST-NOUN	`bozayý`
bozgeven	POST-NOUN	`bozgeven`
bozördek	POST-NOUN	`bozördek`
böbürtü	POST-NOUN	`böbürtü`
böcekbaþý	POST-NOUN	`böcekbaþý`
böcekkabuðu	POST-NOUN	`böcekkabuðu`
böceksavar	POST-NOUN	`böceksavar`
böðür	POST-NOUN	`böðür`
bölen	POST-NOUN	`bölen`
bölmeç	POST-NOUN	`bölmeç`
bölükbaþý	POST-NOUN	`bölükbaþý`
bölünen	POST-NOUN	`bölünen`
bölüngü	POST-NOUN	`bölüngü`
bölüþüm	POST-NOUN	`bölüþüm`
börk	POST-NOUN	`börk`
brahman	POST-NOUN	`brahman`
brahmanizm	POST-NOUN	`brahmanizm`
braket	POST-NOUN	`braket`
brehmen	POST-NOUN	`brehmen`
brezil	POST-NOUN	`brezil`
briz	POST-NOUN	`briz`
brizbiz	POST-NOUN	`brizbiz`
broker	POST-NOUN	`broker`
brovning	POST-NOUN	`brovning`
buat	POST-NOUN	`buat`
buddhist	POST-NOUN	`buddhist`
buddhizm	POST-NOUN	`buddhizm`
budist	POST-NOUN	`budist`
budizm	POST-NOUN	`budizm`
buðdaycýl	POST-NOUN	`buðdaycýl`
buðuevi	POST-NOUN	`buðuevi`
buður	POST-NOUN	`buður`
buðuz	POST-NOUN	`buðuz`
bukanak	POST-NOUN	`bukanak`
buke	POST-NOUN	`buke`
bul	POST-NOUN	`bul`
bula	POST-NOUN	`bula`
bulancak	POST-NOUN	`bulancak`
bulaþýkhane	POST-NOUN	`bulaþýkhane`
buldok	POST-NOUN	`buldok`
bulgar	POST-NOUN	`bulgar`
bulutçuk	POST-NOUN	`bulutçuk`
burak	POST-NOUN	`burak`
burasý	POST-NOUN	`burasý`
burlesk	POST-NOUN	`burlesk`
burun	POST-NOUN	`burun`
buselikaþiran	POST-NOUN	`buselikaþiran`
buþon	POST-NOUN	`buþon`
but	POST-NOUN	`but`
butafor	POST-NOUN	`butafor`
butik	POST-NOUN	`butik`
buton	POST-NOUN	`buton`
buyot	POST-NOUN	`buyot`
buzdolabý	POST-NOUN	`buzdolabý`
buzuki	POST-NOUN	`buzuki`
bügdüz	POST-NOUN	`bügdüz`
büðe	POST-NOUN	`büðe`
bühtan	POST-NOUN	`bühtan`
bük	POST-NOUN	`bük`
büken	POST-NOUN	`büken`
büküç	POST-NOUN	`büküç`
bülbülkonaðý	POST-NOUN	`bülbülkonaðý`
bülbülyuvasý	POST-NOUN	`bülbülyuvasý`
büluð	POST-NOUN	`büluð`
bürudet	POST-NOUN	`bürudet`
bürük	POST-NOUN	`bürük`
bürümçek	POST-NOUN	`bürümçek`
büryan	POST-NOUN	`büryan`
büstiyer	POST-NOUN	`büstiyer`
büten	POST-NOUN	`büten`
bütün	POST-NOUN	`bütün`
büyükayý	POST-NOUN	`büyükayý`
büyükþehir	POST-NOUN	`büyükþehir`
büyülteç	POST-NOUN	`büyülteç`
büzgülemek	POST-NOUN	`büzgülemek`
caferi	POST-NOUN	`caferi`
cahiliyet	POST-NOUN	`cahiliyet`
caize	POST-NOUN	`caize`
cam	POST-NOUN	`cam`
camevi	POST-NOUN	`camevi`
camgöbeði	POST-NOUN	`camgöbeði`
canevi	POST-NOUN	`canevi`
cankulaðý	POST-NOUN	`cankulaðý`
cantiyane	POST-NOUN	`cantiyane`
catering	POST-NOUN	`catering`
cazbant	POST-NOUN	`cazbant`
cebin	POST-NOUN	`cebin`
cebir	POST-NOUN	`cebir`
cebir	POST-NOUN	`cebir`
cebrail	POST-NOUN	`cebrail`
cebrinefis	POST-NOUN	`cebrinefis`
cebriye	POST-NOUN	`cebriye`
cedel	POST-NOUN	`cedel`
cedi	POST-NOUN	`cedi`
cehil	POST-NOUN	`cehil`
ceht	POST-NOUN	`ceht`
ceketatay	POST-NOUN	`ceketatay`
celal	POST-NOUN	`celal`
celep	POST-NOUN	`celep`
celp	POST-NOUN	`celp`
cem	POST-NOUN	`cem`
cemaat	POST-NOUN	`cemaat`
cemaatimüslimin	POST-NOUN	`cemaatimüslimin`
cemadat	POST-NOUN	`cemadat`
cemal	POST-NOUN	`cemal`
cemaziyelahir	POST-NOUN	`cemaziyelahir`
cemaziyelevvel	POST-NOUN	`cemaziyelevvel`
cembiye	POST-NOUN	`cembiye`
cemevi	POST-NOUN	`cemevi`
cenabýhak	POST-NOUN	`cenabýhak`
cenap	POST-NOUN	`cenap`
ceninisakýt	POST-NOUN	`ceninisakýt`
center	POST-NOUN	`center`
cenup	POST-NOUN	`cenup`
cep	POST-NOUN	`cep`
cerahat	POST-NOUN	`cerahat`
cerh	POST-NOUN	`cerh`
ceriha	POST-NOUN	`ceriha`
cermen	POST-NOUN	`cermen`
cerrar	POST-NOUN	`cerrar`
ceset	POST-NOUN	`ceset`
cet	POST-NOUN	`cet`
cevap	POST-NOUN	`cevap`
cevir	POST-NOUN	`cevir`
cevvaliyet	POST-NOUN	`cevvaliyet`
cevza	POST-NOUN	`cevza`
cezaevi	POST-NOUN	`cezaevi`
cezerye	POST-NOUN	`cezerye`
cezir	POST-NOUN	`cezir`
cezire	POST-NOUN	`cezire`
cezp	POST-NOUN	`cezp`
change	POST-NOUN	`change`
charter	POST-NOUN	`charter`
chat	POST-NOUN	`chat`
chobitation	POST-NOUN	`chobitation`
cýda	POST-NOUN	`cýda`
cýdak	POST-NOUN	`cýdak`
cýgara	POST-NOUN	`cýgara`
cýva	POST-NOUN	`cýva`
cýzgara	POST-NOUN	`cýzgara`
cibin	POST-NOUN	`cibin`
cidal	POST-NOUN	`cidal`
cife	POST-NOUN	`cife`
cigara	POST-NOUN	`cigara`
cihat	POST-NOUN	`cihat`
ciklet	POST-NOUN	`ciklet`
cilban	POST-NOUN	`cilban`
cilbent	POST-NOUN	`cilbent`
cilt	POST-NOUN	`cilt`
ciltevi	POST-NOUN	`ciltevi`
cimnastik	POST-NOUN	`cimnastik`
cins	POST-NOUN	`cins`
cinsilatif	POST-NOUN	`cinsilatif`
cips	POST-NOUN	`cips`
cirit	POST-NOUN	`cirit`
cirlop	POST-NOUN	`cirlop`
cisim	POST-NOUN	`cisim`
civankaþý	POST-NOUN	`civankaþý`
civanperçemi	POST-NOUN	`civanperçemi`
cizvit	POST-NOUN	`cizvit`
coþuntu	POST-NOUN	`coþuntu`
cönk	POST-NOUN	`cönk`
cönk	POST-NOUN	`cönk`
cukka	POST-NOUN	`cukka`
cumbalak	POST-NOUN	`cumbalak`
cumhurbaþkaný	POST-NOUN	`cumhurbaþkaný`
cumhurbaþkanlýðý	POST-NOUN	`cumhurbaþkanlýðý`
curnal	POST-NOUN	`curnal`
cülusiye	POST-NOUN	`cülusiye`
cümudiye	POST-NOUN	`cümudiye`
cünha	POST-NOUN	`cünha`
cünun	POST-NOUN	`cünun`
cürmümeþhut	POST-NOUN	`cürmümeþhut`
cürüm	POST-NOUN	`cürüm`
cüzzam	POST-NOUN	`cüzzam`
çadýruþaðý	POST-NOUN	`çadýruþaðý`
çaðýrý	POST-NOUN	`çaðýrý`
çaðýrým	POST-NOUN	`çaðýrým`
çaðýrtmaç	POST-NOUN	`çaðýrtmaç`
çaðlayan	POST-NOUN	`çaðlayan`
çak	POST-NOUN	`çak`
çakaralmaz	POST-NOUN	`çakaralmaz`
çaker	POST-NOUN	`çaker`
çakýntý	POST-NOUN	`çakýntý`
çakýrkanat	POST-NOUN	`çakýrkanat`
çakra	POST-NOUN	`çakra`
çalacak	POST-NOUN	`çalacak`
çalgýhane	POST-NOUN	`çalgýhane`
çalgýn	POST-NOUN	`çalgýn`
çalýþtay	POST-NOUN	`çalýþtay`
çalýþtýran	POST-NOUN	`çalýþtýran`
çalký	POST-NOUN	`çalký`
çalmaç	POST-NOUN	`çalmaç`
çaltý	POST-NOUN	`çaltý`
çamat	POST-NOUN	`çamat`
çandý	POST-NOUN	`çandý`
çangal	POST-NOUN	`çangal`
çangal	POST-NOUN	`çangal`
çapari	POST-NOUN	`çapari`
çapçak	POST-NOUN	`çapçak`
çapula	POST-NOUN	`çapula`
çardaþ	POST-NOUN	`çardaþ`
çareviç	POST-NOUN	`çareviç`
çark	POST-NOUN	`çark`
çarka	POST-NOUN	`çarka`
çarpan	POST-NOUN	`çarpan`
çarpýlan	POST-NOUN	`çarpýlan`
çaþýt	POST-NOUN	`çaþýt`
çatalkuyruk	POST-NOUN	`çatalkuyruk`
çavdarmahmuzu	POST-NOUN	`çavdarmahmuzu`
çavuldur	POST-NOUN	`çavuldur`
çayan	POST-NOUN	`çayan`
çaydaçýra	POST-NOUN	`çaydaçýra`
çayevi	POST-NOUN	`çayevi`
çayýrsedefi	POST-NOUN	`çayýrsedefi`
çaykara	POST-NOUN	`çaykara`
çebiç	POST-NOUN	`çebiç`
çeç	POST-NOUN	`çeç`
çeçen	POST-NOUN	`çeçen`
çedene	POST-NOUN	`çedene`
çek	POST-NOUN	`çek`
çek	POST-NOUN	`çek`
çekberi	POST-NOUN	`çekberi`
çekecek	POST-NOUN	`çekecek`
çekiþte	POST-NOUN	`çekiþte`
çekoslovak	POST-NOUN	`çekoslovak`
çekyat	POST-NOUN	`çekyat`
çelek	POST-NOUN	`çelek`
çelen	POST-NOUN	`çelen`
çelikhane	POST-NOUN	`çelikhane`
çeltek	POST-NOUN	`çeltek`
çemiç	POST-NOUN	`çemiç`
çengüçegane	POST-NOUN	`çengüçegane`
çepez	POST-NOUN	`çepez`
çepni	POST-NOUN	`çepni`
çeribaþý	POST-NOUN	`çeribaþý`
çerkez	POST-NOUN	`çerkez`
çerkeztavuðu	POST-NOUN	`çerkeztavuðu`
çeþit	POST-NOUN	`çeþit`
çeþnicibaþý	POST-NOUN	`çeþnicibaþý`
çevirge	POST-NOUN	`çevirge`
çýbanbaþý	POST-NOUN	`çýbanbaþý`
çýkacak	POST-NOUN	`çýkacak`
çýkan	POST-NOUN	`çýkan`
çýkýt	POST-NOUN	`çýkýt`
çýkrýkçýn	POST-NOUN	`çýkrýkçýn`
çýlkava	POST-NOUN	`çýlkava`
çýmbar	POST-NOUN	`çýmbar`
çýnayaz	POST-NOUN	`çýnayaz`
çýpýr	POST-NOUN	`çýpýr`
çýrað	POST-NOUN	`çýrað`
çýrçýl	POST-NOUN	`çýrçýl`
çiçekevi	POST-NOUN	`çiçekevi`
çiçeksever	POST-NOUN	`çiçeksever`
çift	POST-NOUN	`çift`
çiðil	POST-NOUN	`çiðil`
çiðit	POST-NOUN	`çiðit`
çilehane	POST-NOUN	`çilehane`
çingen	POST-NOUN	`çingen`
çinko	POST-NOUN	`çinko`
çinko	POST-NOUN	`çinko`
çintiyan	POST-NOUN	`çintiyan`
çip	POST-NOUN	`çip`
çipilti	POST-NOUN	`çipilti`
çirkef	POST-NOUN	`çirkef`
çise	POST-NOUN	`çise`
çita	POST-NOUN	`çita`
çivit	POST-NOUN	`çivit`
çiviyukarý	POST-NOUN	`çiviyukarý`
çizecek	POST-NOUN	`çizecek`
çobançantasý	POST-NOUN	`çobançantasý`
çobandaðarcýðý	POST-NOUN	`çobandaðarcýðý`
çobandeðneði	POST-NOUN	`çobandeðneði`
çobandüdüðü	POST-NOUN	`çobandüdüðü`
çobantaraðý	POST-NOUN	`çobantaraðý`
çobantuzluðu	POST-NOUN	`çobantuzluðu`
çobanüzümü	POST-NOUN	`çobanüzümü`
çocukcaðýz	POST-NOUN	`çocukcaðýz`
çoðaltan	POST-NOUN	`çoðaltan`
çoksatar	POST-NOUN	`çoksatar`
çolpan	POST-NOUN	`çolpan`
çorap	POST-NOUN	`çorap`
çotanak	POST-NOUN	`çotanak`
çökerti	POST-NOUN	`çökerti`
çördek	POST-NOUN	`çördek`
çöreotu	POST-NOUN	`çöreotu`
çözüntü	POST-NOUN	`çözüntü`
çuhçuh	POST-NOUN	`çuhçuh`
çuka	POST-NOUN	`çuka`
çulpan	POST-NOUN	`çulpan`
çultar	POST-NOUN	`çultar`
çupra	POST-NOUN	`çupra`
çuþka	POST-NOUN	`çuþka`
çuvaþ	POST-NOUN	`çuvaþ`
çük	POST-NOUN	`çük`
çükündür	POST-NOUN	`çükündür`
çükür	POST-NOUN	`çükür`
dadaist	POST-NOUN	`dadaist`
daðalasý	POST-NOUN	`daðalasý`
daðbaþý	POST-NOUN	`daðbaþý`
daðýntý	POST-NOUN	`daðýntý`
daðýtýmevi	POST-NOUN	`daðýtýmevi`
daði	POST-NOUN	`daði`
dahasý	POST-NOUN	`dahasý`
daktilotekni	POST-NOUN	`daktilotekni`
dalan	POST-NOUN	`dalan`
dalfes	POST-NOUN	`dalfes`
dalfidan	POST-NOUN	`dalfidan`
dalgaölçer	POST-NOUN	`dalgaölçer`
dalkavuk	POST-NOUN	`dalkavuk`
dalöðle	POST-NOUN	`dalöðle`
damat	POST-NOUN	`damat`
danaayaðý	POST-NOUN	`danaayaðý`
danaburnu	POST-NOUN	`danaburnu`
dane	POST-NOUN	`dane`
dang	POST-NOUN	`dang`
daniþment	POST-NOUN	`daniþment`
dansimetre	POST-NOUN	`dansimetre`
dansing	POST-NOUN	`dansing`
dantela	POST-NOUN	`dantela`
dar	POST-NOUN	`dar`
dar	POST-NOUN	`dar`
dar	POST-NOUN	`dar`
daraltý	POST-NOUN	`daraltý`
darbýmesel	POST-NOUN	`darbýmesel`
darýfülfül	POST-NOUN	`darýfülfül`
darmstadtiyum	POST-NOUN	`darmstadtiyum`
daru	POST-NOUN	`daru`
darülbedayi	POST-NOUN	`darülbedayi`
darüleytam	POST-NOUN	`darüleytam`
darüþþifa	POST-NOUN	`darüþþifa`
dasitan	POST-NOUN	`dasitan`
dasnik	POST-NOUN	`dasnik`
data	POST-NOUN	`data`
davraným	POST-NOUN	`davraným`
davultozu	POST-NOUN	`davultozu`
dayantý	POST-NOUN	`dayantý`
daye	POST-NOUN	`daye`
daylak	POST-NOUN	`daylak`
dazkýr	POST-NOUN	`dazkýr`
de	POST-NOUN	`de`
debagat	POST-NOUN	`debagat`
debbað	POST-NOUN	`debbað`
debbe	POST-NOUN	`debbe`
debboy	POST-NOUN	`debboy`
debimetre	POST-NOUN	`debimetre`
dedantör	POST-NOUN	`dedantör`
dedüksiyon	POST-NOUN	`dedüksiyon`
def	POST-NOUN	`def`
def	POST-NOUN	`def`
defaat	POST-NOUN	`defaat`
defans	POST-NOUN	`defans`
defi	POST-NOUN	`defi`
defibratör	POST-NOUN	`defibratör`
defihacet	POST-NOUN	`defihacet`
defin	POST-NOUN	`defin`
defneyapraðý	POST-NOUN	`defneyapraðý`
defroster	POST-NOUN	`defroster`
defterikebir	POST-NOUN	`defterikebir`
degaj	POST-NOUN	`degaj`
deðin	POST-NOUN	`deðin`
deðini	POST-NOUN	`deðini`
deðinti	POST-NOUN	`deðinti`
deðiþik	POST-NOUN	`deðiþik`
deðiþinim	POST-NOUN	`deðiþinim`
dehdeh	POST-NOUN	`dehdeh`
deist	POST-NOUN	`deist`
deizm	POST-NOUN	`deizm`
dejavu	POST-NOUN	`dejavu`
dek	POST-NOUN	`dek`
dekametre	POST-NOUN	`dekametre`
dekoder	POST-NOUN	`dekoder`
dekstroz	POST-NOUN	`dekstroz`
delecek	POST-NOUN	`delecek`
delgiç	POST-NOUN	`delgiç`
delibaþ	POST-NOUN	`delibaþ`
deliboynuz	POST-NOUN	`deliboynuz`
delk	POST-NOUN	`delk`
demetçik	POST-NOUN	`demetçik`
demir	POST-NOUN	`demir`
demiri	POST-NOUN	`demiri`
demirkazýk	POST-NOUN	`demirkazýk`
demirleblebi	POST-NOUN	`demirleblebi`
demiurgos	POST-NOUN	`demiurgos`
demonstrasyon	POST-NOUN	`demonstrasyon`
denaet	POST-NOUN	`denaet`
dendroloji	POST-NOUN	`dendroloji`
denet	POST-NOUN	`denet`
deneyüstü	POST-NOUN	`deneyüstü`
dengeþik	POST-NOUN	`dengeþik`
denim	POST-NOUN	`denim`
denizalasý	POST-NOUN	`denizalasý`
denizanasý	POST-NOUN	`denizanasý`
denizaslaný	POST-NOUN	`denizaslaný`
denizatý	POST-NOUN	`denizatý`
denizaygýrý	POST-NOUN	`denizaygýrý`
denizayýsý	POST-NOUN	`denizayýsý`
denizçakýsý	POST-NOUN	`denizçakýsý`
denizgergedaný	POST-NOUN	`denizgergedaný`
denizhýyarý	POST-NOUN	`denizhýyarý`
denizhýyarlarý	POST-NOUN	`denizhýyarlarý`
denizýsýrganlarý	POST-NOUN	`denizýsýrganlarý`
denizibiði	POST-NOUN	`denizibiði`
denizineði	POST-NOUN	`denizineði`
denizkadayýfý	POST-NOUN	`denizkadayýfý`
denizkýzý	POST-NOUN	`denizkýzý`
denizkozalaðý	POST-NOUN	`denizkozalaðý`
denizköpüðü	POST-NOUN	`denizköpüðü`
denizkulaðý	POST-NOUN	`denizkulaðý`
denizlaleleri	POST-NOUN	`denizlaleleri`
denizmaymunu	POST-NOUN	`denizmaymunu`
denizpalamudu	POST-NOUN	`denizpalamudu`
denizpelidi	POST-NOUN	`denizpelidi`
denizpýrasasý	POST-NOUN	`denizpýrasasý`
denizþakayýðý	POST-NOUN	`denizþakayýðý`
denizþakayýklarý	POST-NOUN	`denizþakayýklarý`
deniztaraðý	POST-NOUN	`deniztaraðý`
deniztavþaný	POST-NOUN	`deniztavþaný`
denizüzümü	POST-NOUN	`denizüzümü`
denizyýldýzý	POST-NOUN	`denizyýldýzý`
densimetre	POST-NOUN	`densimetre`
denyo	POST-NOUN	`denyo`
deodorant	POST-NOUN	`deodorant`
deontoloji	POST-NOUN	`deontoloji`
depolitizasyon	POST-NOUN	`depolitizasyon`
depozito	POST-NOUN	`depozito`
depremçizer	POST-NOUN	`depremçizer`
depremzede	POST-NOUN	`depremzede`
derbent	POST-NOUN	`derbent`
derbi	POST-NOUN	`derbi`
derebeyi	POST-NOUN	`derebeyi`
dereotu	POST-NOUN	`dereotu`
deri	POST-NOUN	`deri`
deri	POST-NOUN	`deri`
derinlikölçer	POST-NOUN	`derinlikölçer`
derk	POST-NOUN	`derk`
dermatit	POST-NOUN	`dermatit`
dermatolog	POST-NOUN	`dermatolog`
dermatoloji	POST-NOUN	`dermatoloji`
dermeyan	POST-NOUN	`dermeyan`
dermit	POST-NOUN	`dermit`
dernekevi	POST-NOUN	`dernekevi`
derogasyon	POST-NOUN	`derogasyon`
dersiam	POST-NOUN	`dersiam`
dert	POST-NOUN	`dert`
desikatör	POST-NOUN	`desikatör`
desimal	POST-NOUN	`desimal`
desimetre	POST-NOUN	`desimetre`
despot	POST-NOUN	`despot`
despot	POST-NOUN	`despot`
destar	POST-NOUN	`destar`
destari	POST-NOUN	`destari`
destere	POST-NOUN	`destere`
determinasyon	POST-NOUN	`determinasyon`
devaimisk	POST-NOUN	`devaimisk`
deveboynu	POST-NOUN	`deveboynu`
deveelmasý	POST-NOUN	`deveelmasý`
devegözü	POST-NOUN	`devegözü`
developer	POST-NOUN	`developer`
developman	POST-NOUN	`developman`
deveranýdem	POST-NOUN	`deveranýdem`
devetabaný	POST-NOUN	`devetabaný`
devetüyü	POST-NOUN	`devetüyü`
devir	POST-NOUN	`devir`
devir	POST-NOUN	`devir`
devrialem	POST-NOUN	`devrialem`
devrihindi	POST-NOUN	`devrihindi`
devrikebir	POST-NOUN	`devrikebir`
devrirevan	POST-NOUN	`devrirevan`
devrisaadet	POST-NOUN	`devrisaadet`
dezenfeksiyon	POST-NOUN	`dezenfeksiyon`
dýðan	POST-NOUN	`dýðan`
dýðdýk	POST-NOUN	`dýðdýk`
dýmýþki	POST-NOUN	`dýmýþki`
dýramudana	POST-NOUN	`dýramudana`
dýþkýsever	POST-NOUN	`dýþkýsever`
dýzdýk	POST-NOUN	`dýzdýk`
dialkol	POST-NOUN	`dialkol`
diaspora	POST-NOUN	`diaspora`
dide	POST-NOUN	`dide`
dideban	POST-NOUN	`dideban`
didinti	POST-NOUN	`didinti`
didiþim	POST-NOUN	`didiþim`
didona	POST-NOUN	`didona`
difenbahya	POST-NOUN	`difenbahya`
diferansiyel	POST-NOUN	`diferansiyel`
difraksiyon	POST-NOUN	`difraksiyon`
difteri	POST-NOUN	`difteri`
difüzyon	POST-NOUN	`difüzyon`
dijital	POST-NOUN	`dijital`
dikimevi	POST-NOUN	`dikimevi`
dikimhane	POST-NOUN	`dikimhane`
dikkat	POST-NOUN	`dikkat`
dikkuyruk	POST-NOUN	`dikkuyruk`
dilaltý	POST-NOUN	`dilaltý`
dilatometre	POST-NOUN	`dilatometre`
dilaver	POST-NOUN	`dilaver`
dilberdudaðý	POST-NOUN	`dilberdudaðý`
dildaþ	POST-NOUN	`dildaþ`
dimmer	POST-NOUN	`dimmer`
dimnit	POST-NOUN	`dimnit`
dinamik	POST-NOUN	`dinamik`
dinamometre	POST-NOUN	`dinamometre`
dine	POST-NOUN	`dine`
dinek	POST-NOUN	`dinek`
dingo	POST-NOUN	`dingo`
dinozor	POST-NOUN	`dinozor`
dip	POST-NOUN	`dip`
dipdam	POST-NOUN	`dipdam`
diploit	POST-NOUN	`diploit`
disk	POST-NOUN	`disk`
diskjokey	POST-NOUN	`diskjokey`
disko	POST-NOUN	`disko`
disponibilite	POST-NOUN	`disponibilite`
distribütör	POST-NOUN	`distribütör`
diþçik	POST-NOUN	`diþçik`
diþi	POST-NOUN	`diþi`
div	POST-NOUN	`div`
divanýharp	POST-NOUN	`divanýharp`
divanýhümayun	POST-NOUN	`divanýhümayun`
diya	POST-NOUN	`diya`
diyabetolog	POST-NOUN	`diyabetolog`
diyabetoloji	POST-NOUN	`diyabetoloji`
diyafon	POST-NOUN	`diyafon`
diyagonal	POST-NOUN	`diyagonal`
diyalektolog	POST-NOUN	`diyalektolog`
diyalektoloji	POST-NOUN	`diyalektoloji`
diyalog	POST-NOUN	`diyalog`
diyarýgurbet	POST-NOUN	`diyarýgurbet`
diyetetik	POST-NOUN	`diyetetik`
diyetisyen	POST-NOUN	`diyetisyen`
dizek	POST-NOUN	`dizek`
dizmen	POST-NOUN	`dizmen`
dizüstü	POST-NOUN	`dizüstü`
dodurga	POST-NOUN	`dodurga`
doðan	POST-NOUN	`doðan`
doðu	POST-NOUN	`doðu`
doðu	POST-NOUN	`doðu`
doðumevi	POST-NOUN	`doðumevi`
doðumhane	POST-NOUN	`doðumhane`
doðurgu	POST-NOUN	`doðurgu`
dok	POST-NOUN	`dok`
doksan	POST-NOUN	`doksan`
dokumahane	POST-NOUN	`dokumahane`
dokunmabana	POST-NOUN	`dokunmabana`
dokurcuk	POST-NOUN	`dokurcuk`
dokuz	POST-NOUN	`dokuz`
dokuzaltmýþbeþ	POST-NOUN	`dokuzaltmýþbeþ`
dokuzgen	POST-NOUN	`dokuzgen`
dolaným	POST-NOUN	`dolaným`
dolantý	POST-NOUN	`dolantý`
dolap	POST-NOUN	`dolap`
dolum	POST-NOUN	`dolum`
domdom	POST-NOUN	`domdom`
domestik	POST-NOUN	`domestik`
domuzayaðý	POST-NOUN	`domuzayaðý`
domuztýrnaðý	POST-NOUN	`domuztýrnaðý`
donam	POST-NOUN	`donam`
donduraç	POST-NOUN	`donduraç`
dorse	POST-NOUN	`dorse`
doyumevi	POST-NOUN	`doyumevi`
doyuran	POST-NOUN	`doyuran`
döger	POST-NOUN	`döger`
dökülgen	POST-NOUN	`dökülgen`
dökümevi	POST-NOUN	`dökümevi`
dömivole	POST-NOUN	`dömivole`
dönüt	POST-NOUN	`dönüt`
dört	POST-NOUN	`dört`
dörtçeker	POST-NOUN	`dörtçeker`
dörtçifte	POST-NOUN	`dörtçifte`
dörttek	POST-NOUN	`dörttek`
döþgömü	POST-NOUN	`döþgömü`
döven	POST-NOUN	`döven`
dövizzede	POST-NOUN	`dövizzede`
dragoman	POST-NOUN	`dragoman`
dramaturji	POST-NOUN	`dramaturji`
dreç	POST-NOUN	`dreç`
dripling	POST-NOUN	`dripling`
drog	POST-NOUN	`drog`
drosera	POST-NOUN	`drosera`
dubniyum	POST-NOUN	`dubniyum`
dudakdeðmez	POST-NOUN	`dudakdeðmez`
duhul	POST-NOUN	`duhul`
duo	POST-NOUN	`duo`
duynak	POST-NOUN	`duynak`
duyultu	POST-NOUN	`duyultu`
duyurum	POST-NOUN	`duyurum`
dübbüasgar	POST-NOUN	`dübbüasgar`
dübbüekber	POST-NOUN	`dübbüekber`
dübel	POST-NOUN	`dübel`
dügah	POST-NOUN	`dügah`
düðmük	POST-NOUN	`düðmük`
düðüncübaþý	POST-NOUN	`düðüncübaþý`
dük	POST-NOUN	`dük`
dümbük	POST-NOUN	`dümbük`
dümenevi	POST-NOUN	`dümenevi`
dümtek	POST-NOUN	`dümtek`
dünyaevi	POST-NOUN	`dünyaevi`
dürzi	POST-NOUN	`dürzi`
düþkünlerevi	POST-NOUN	`düþkünlerevi`
düþman	POST-NOUN	`düþman`
düþünüm	POST-NOUN	`düþünüm`
düttürü	POST-NOUN	`düttürü`
düven	POST-NOUN	`düven`
düver	POST-NOUN	`düver`
düz	POST-NOUN	`düz`
düz	POST-NOUN	`düz`
düzeltim	POST-NOUN	`düzeltim`
düzenleþim	POST-NOUN	`düzenleþim`
düzgün	POST-NOUN	`düzgün`
düziko	POST-NOUN	`düziko`
ebat	POST-NOUN	`ebat`
ebcet	POST-NOUN	`ebcet`
ebebulguru	POST-NOUN	`ebebulguru`
ebekuþaðý	POST-NOUN	`ebekuþaðý`
ebemkuþaðý	POST-NOUN	`ebemkuþaðý`
ebet	POST-NOUN	`ebet`
ebussuut	POST-NOUN	`ebussuut`
ecdat	POST-NOUN	`ecdat`
ecir	POST-NOUN	`ecir`
eczahane	POST-NOUN	`eczahane`
edebikelam	POST-NOUN	`edebikelam`
edep	POST-NOUN	`edep`
edi	POST-NOUN	`edi`
edi	POST-NOUN	`edi`
edip	POST-NOUN	`edip`
edirnekari	POST-NOUN	`edirnekari`
edvar	POST-NOUN	`edvar`
efendibaba	POST-NOUN	`efendibaba`
eflak	POST-NOUN	`eflak`
eflatun	POST-NOUN	`eflatun`
efor	POST-NOUN	`efor`
efrat	POST-NOUN	`efrat`
efsun	POST-NOUN	`efsun`
ege	POST-NOUN	`ege`
eglog	POST-NOUN	`eglog`
eðin	POST-NOUN	`eðin`
eðir	POST-NOUN	`eðir`
eðitbilim	POST-NOUN	`eðitbilim`
eðmür	POST-NOUN	`eðmür`
eðrelti	POST-NOUN	`eðrelti`
eðrez	POST-NOUN	`eðrez`
ehil	POST-NOUN	`ehil`
ehlibeyit	POST-NOUN	`ehlibeyit`
ehlikeyif	POST-NOUN	`ehlikeyif`
ehlikitap	POST-NOUN	`ehlikitap`
ehlisalip	POST-NOUN	`ehlisalip`
ehlisünnet	POST-NOUN	`ehlisünnet`
ehlizevk	POST-NOUN	`ehlizevk`
ehveniyet	POST-NOUN	`ehveniyet`
ejektör	POST-NOUN	`ejektör`
ek	POST-NOUN	`ek`
eke	POST-NOUN	`eke`
ekecek	POST-NOUN	`ekecek`
ekinti	POST-NOUN	`ekinti`
ekip	POST-NOUN	`ekip`
ekipman	POST-NOUN	`ekipman`
eklesil	POST-NOUN	`eklesil`
ekliptik	POST-NOUN	`ekliptik`
eko	POST-NOUN	`eko`
ekol	POST-NOUN	`ekol`
ekolog	POST-NOUN	`ekolog`
ekoloji	POST-NOUN	`ekoloji`
ekolojist	POST-NOUN	`ekolojist`
ekolojizm	POST-NOUN	`ekolojizm`
ekonometri	POST-NOUN	`ekonometri`
eksibe	POST-NOUN	`eksibe`
eksibisyonizm	POST-NOUN	`eksibisyonizm`
eksilen	POST-NOUN	`eksilen`
eksin	POST-NOUN	`eksin`
eksperimantalizm	POST-NOUN	`eksperimantalizm`
ekspoze	POST-NOUN	`ekspoze`
ekspozisyon	POST-NOUN	`ekspozisyon`
ekspres	POST-NOUN	`ekspres`
ekstre	POST-NOUN	`ekstre`
ekþikulak	POST-NOUN	`ekþikulak`
ekü	POST-NOUN	`ekü`
elçek	POST-NOUN	`elçek`
elçim	POST-NOUN	`elçim`
elde	POST-NOUN	`elde`
eleji	POST-NOUN	`eleji`
elektroansefalografi	POST-NOUN	`elektroansefalografi`
elektroansefalogram	POST-NOUN	`elektroansefalogram`
elektrobiyoloji	POST-NOUN	`elektrobiyoloji`
elektrodinamometre	POST-NOUN	`elektrodinamometre`
elektrodiyaliz	POST-NOUN	`elektrodiyaliz`
elektrofil	POST-NOUN	`elektrofil`
elektrofon	POST-NOUN	`elektrofon`
elektrogitar	POST-NOUN	`elektrogitar`
elektrokardiyograf	POST-NOUN	`elektrokardiyograf`
elektrokardiyografi	POST-NOUN	`elektrokardiyografi`
elektrokardiyogram	POST-NOUN	`elektrokardiyogram`
elektrokimya	POST-NOUN	`elektrokimya`
elektrometalürji	POST-NOUN	`elektrometalürji`
elektrometre	POST-NOUN	`elektrometre`
elektromobil	POST-NOUN	`elektromobil`
elektronik	POST-NOUN	`elektronik`
elektroradyoloji	POST-NOUN	`elektroradyoloji`
elektrosaz	POST-NOUN	`elektrosaz`
elektroþok	POST-NOUN	`elektroþok`
elibelinde	POST-NOUN	`elibelinde`
eliböðründe	POST-NOUN	`eliböðründe`
eliminasyon	POST-NOUN	`eliminasyon`
elipsoit	POST-NOUN	`elipsoit`
elmas	POST-NOUN	`elmas`
elmek	POST-NOUN	`elmek`
elöpen	POST-NOUN	`elöpen`
eltieltiyeküstü	POST-NOUN	`eltieltiyeküstü`
eman	POST-NOUN	`eman`
emanetullah	POST-NOUN	`emanetullah`
embriyo	POST-NOUN	`embriyo`
embriyolog	POST-NOUN	`embriyolog`
embriyoloji	POST-NOUN	`embriyoloji`
emcek	POST-NOUN	`emcek`
emen	POST-NOUN	`emen`
emir	POST-NOUN	`emir`
emir	POST-NOUN	`emir`
empati	POST-NOUN	`empati`
empermeabl	POST-NOUN	`empermeabl`
emraz	POST-NOUN	`emraz`
emrihak	POST-NOUN	`emrihak`
emsal	POST-NOUN	`emsal`
emval	POST-NOUN	`emval`
enaniyet	POST-NOUN	`enaniyet`
enderun	POST-NOUN	`enderun`
endoderm	POST-NOUN	`endoderm`
endogami	POST-NOUN	`endogami`
endokrin	POST-NOUN	`endokrin`
endokrinoloji	POST-NOUN	`endokrinoloji`
endoskop	POST-NOUN	`endoskop`
endoskopi	POST-NOUN	`endoskopi`
endüksiyon	POST-NOUN	`endüksiyon`
enfrastrüktür	POST-NOUN	`enfrastrüktür`
enjekte	POST-NOUN	`enjekte`
ensar	POST-NOUN	`ensar`
ensest	POST-NOUN	`ensest`
entel	POST-NOUN	`entel`
enterfon	POST-NOUN	`enterfon`
enterkoneksiyon	POST-NOUN	`enterkoneksiyon`
entomoloji	POST-NOUN	`entomoloji`
entomolojist	POST-NOUN	`entomolojist`
entropi	POST-NOUN	`entropi`
envestisman	POST-NOUN	`envestisman`
eper	POST-NOUN	`eper`
epidemioloji	POST-NOUN	`epidemioloji`
epiderm	POST-NOUN	`epiderm`
epigram	POST-NOUN	`epigram`
epilasyon	POST-NOUN	`epilasyon`
epilog	POST-NOUN	`epilog`
episantýr	POST-NOUN	`episantýr`
episot	POST-NOUN	`episot`
epistemoloji	POST-NOUN	`epistemoloji`
epitel	POST-NOUN	`epitel`
epizot	POST-NOUN	`epizot`
eradikasyon	POST-NOUN	`eradikasyon`
erbap	POST-NOUN	`erbap`
eren	POST-NOUN	`eren`
erendiz	POST-NOUN	`erendiz`
erika	POST-NOUN	`erika`
erk	POST-NOUN	`erk`
erkanýharbiyeiumumiye	POST-NOUN	`erkanýharbiyeiumumiye`
erkanýharp	POST-NOUN	`erkanýharp`
erkek	POST-NOUN	`erkek`
erkekevi	POST-NOUN	`erkekevi`
ermeni	POST-NOUN	`ermeni`
ermin	POST-NOUN	`ermin`
erupsiyon	POST-NOUN	`erupsiyon`
ervah	POST-NOUN	`ervah`
esbabýmucibe	POST-NOUN	`esbabýmucibe`
esbap	POST-NOUN	`esbap`
esericedit	POST-NOUN	`esericedit`
esik	POST-NOUN	`esik`
esire	POST-NOUN	`esire`
eskalop	POST-NOUN	`eskalop`
eski	POST-NOUN	`eski`
eskimo	POST-NOUN	`eskimo`
eskort	POST-NOUN	`eskort`
esmayýhüsna	POST-NOUN	`esmayýhüsna`
esmayýþerife	POST-NOUN	`esmayýþerife`
esmer	POST-NOUN	`esmer`
esperanto	POST-NOUN	`esperanto`
espiyon	POST-NOUN	`espiyon`
espresso	POST-NOUN	`espresso`
estampaj	POST-NOUN	`estampaj`
esvap	POST-NOUN	`esvap`
eþantiyon	POST-NOUN	`eþantiyon`
eþarp	POST-NOUN	`eþarp`
eþekbaþý	POST-NOUN	`eþekbaþý`
eþekkulaðý	POST-NOUN	`eþekkulaðý`
eþeksýrtý	POST-NOUN	`eþeksýrtý`
eþhas	POST-NOUN	`eþhas`
eþkal	POST-NOUN	`eþkal`
etanol	POST-NOUN	`etanol`
etap	POST-NOUN	`etap`
etçik	POST-NOUN	`etçik`
etfal	POST-NOUN	`etfal`
eti	POST-NOUN	`eti`
etibba	POST-NOUN	`etibba`
etik	POST-NOUN	`etik`
etimolog	POST-NOUN	`etimolog`
etimoloji	POST-NOUN	`etimoloji`
etiyoloji	POST-NOUN	`etiyoloji`
etnolog	POST-NOUN	`etnolog`
etnoloji	POST-NOUN	`etnoloji`
etol	POST-NOUN	`etol`
etoloji	POST-NOUN	`etoloji`
etriye	POST-NOUN	`etriye`
etüt	POST-NOUN	`etüt`
euro	POST-NOUN	`euro`
eurobond	POST-NOUN	`eurobond`
evcara	POST-NOUN	`evcara`
evcikkýran	POST-NOUN	`evcikkýran`
evç	POST-NOUN	`evç`
eviç	POST-NOUN	`eviç`
eviye	POST-NOUN	`eviye`
evladüiyal	POST-NOUN	`evladüiyal`
evlat	POST-NOUN	`evlat`
evleviyet	POST-NOUN	`evleviyet`
evolüsyon	POST-NOUN	`evolüsyon`
evrat	POST-NOUN	`evrat`
evsin	POST-NOUN	`evsin`
evveliyat	POST-NOUN	`evveliyat`
eymir	POST-NOUN	`eymir`
eytam	POST-NOUN	`eytam`
eyvan	POST-NOUN	`eyvan`
ezgiç	POST-NOUN	`ezgiç`
ezimevi	POST-NOUN	`ezimevi`
ezofori	POST-NOUN	`ezofori`
ezrail	POST-NOUN	`ezrail`
fabl	POST-NOUN	`fabl`
factor	POST-NOUN	`factor`
factoring	POST-NOUN	`factoring`
fahriye	POST-NOUN	`fahriye`
fahte	POST-NOUN	`fahte`
faikiyet	POST-NOUN	`faikiyet`
fak	POST-NOUN	`fak`
fakih	POST-NOUN	`fakih`
fakr	POST-NOUN	`fakr`
faks	POST-NOUN	`faks`
fakül	POST-NOUN	`fakül`
falanj	POST-NOUN	`falanj`
falçata	POST-NOUN	`falçata`
falez	POST-NOUN	`falez`
fallus	POST-NOUN	`fallus`
fan	POST-NOUN	`fan`
fangri	POST-NOUN	`fangri`
fantezist	POST-NOUN	`fantezist`
fantom	POST-NOUN	`fantom`
fanyol	POST-NOUN	`fanyol`
farediþi	POST-NOUN	`farediþi`
farekulaðý	POST-NOUN	`farekulaðý`
farekuyruðu	POST-NOUN	`farekuyruðu`
fark	POST-NOUN	`fark`
farmakodinamik	POST-NOUN	`farmakodinamik`
farmakognozi	POST-NOUN	`farmakognozi`
farmakolog	POST-NOUN	`farmakolog`
farmakoloji	POST-NOUN	`farmakoloji`
fars	POST-NOUN	`fars`
fars	POST-NOUN	`fars`
faset	POST-NOUN	`faset`
fasýl	POST-NOUN	`fasýl`
fasile	POST-NOUN	`fasile`
faþing	POST-NOUN	`faþing`
fatalite	POST-NOUN	`fatalite`
fayans	POST-NOUN	`fayans`
fe	POST-NOUN	`fe`
fecaat	POST-NOUN	`fecaat`
fecir	POST-NOUN	`fecir`
fecrikazip	POST-NOUN	`fecrikazip`
fecrisadýk	POST-NOUN	`fecrisadýk`
fehim	POST-NOUN	`fehim`
fehva	POST-NOUN	`fehva`
fek	POST-NOUN	`fek`
fel	POST-NOUN	`fel`
feldmareþal	POST-NOUN	`feldmareþal`
feldspat	POST-NOUN	`feldspat`
felekiyat	POST-NOUN	`felekiyat`
felemenk	POST-NOUN	`felemenk`
feliks	POST-NOUN	`feliks`
fenafillah	POST-NOUN	`fenafillah`
fenik	POST-NOUN	`fenik`
fenol	POST-NOUN	`fenol`
fenoloji	POST-NOUN	`fenoloji`
fenomenoloji	POST-NOUN	`fenomenoloji`
ferahnak	POST-NOUN	`ferahnak`
ferahnakaþiran	POST-NOUN	`ferahnakaþiran`
ferde	POST-NOUN	`ferde`
ferforje	POST-NOUN	`ferforje`
ferhane	POST-NOUN	`ferhane`
feriþte	POST-NOUN	`feriþte`
fernez	POST-NOUN	`fernez`
fert	POST-NOUN	`fert`
feryat	POST-NOUN	`feryat`
fesahat	POST-NOUN	`fesahat`
fesat	POST-NOUN	`fesat`
fesih	POST-NOUN	`fesih`
festival	POST-NOUN	`festival`
fetha	POST-NOUN	`fetha`
fetih	POST-NOUN	`fetih`
fetüs	POST-NOUN	`fetüs`
fetvahane	POST-NOUN	`fetvahane`
fetvayiþerife	POST-NOUN	`fetvayiþerife`
fevç	POST-NOUN	`fevç`
fevk	POST-NOUN	`fevk`
fevvare	POST-NOUN	`fevvare`
feyiz	POST-NOUN	`feyiz`
fýkdan	POST-NOUN	`fýkdan`
fýkýh	POST-NOUN	`fýkýh`
fýndýkkabuðu	POST-NOUN	`fýndýkkabuðu`
fýrkate	POST-NOUN	`fýrkate`
fýrkateyn	POST-NOUN	`fýrkateyn`
fýskiye	POST-NOUN	`fýskiye`
fýþkýrtý	POST-NOUN	`fýþkýrtý`
fýtriye	POST-NOUN	`fýtriye`
fibrinojen	POST-NOUN	`fibrinojen`
fideizm	POST-NOUN	`fideizm`
fikir	POST-NOUN	`fikir`
fikriyat	POST-NOUN	`fikriyat`
fikstür	POST-NOUN	`fikstür`
fiktif	POST-NOUN	`fiktif`
filaman	POST-NOUN	`filaman`
filatelist	POST-NOUN	`filatelist`
filbahri	POST-NOUN	`filbahri`
fildiþi	POST-NOUN	`fildiþi`
filiskin	POST-NOUN	`filiskin`
filkulaðý	POST-NOUN	`filkulaðý`
filojenez	POST-NOUN	`filojenez`
filolog	POST-NOUN	`filolog`
filoloji	POST-NOUN	`filoloji`
fin	POST-NOUN	`fin`
final	POST-NOUN	`final`
fink	POST-NOUN	`fink`
firkat	POST-NOUN	`firkat`
firuze	POST-NOUN	`firuze`
fiþe	POST-NOUN	`fiþe`
fitin	POST-NOUN	`fitin`
fitocoðrafya	POST-NOUN	`fitocoðrafya`
fitopatoloji	POST-NOUN	`fitopatoloji`
fiyort	POST-NOUN	`fiyort`
fizyolog	POST-NOUN	`fizyolog`
fizyoloji	POST-NOUN	`fizyoloji`
fizyoterapist	POST-NOUN	`fizyoterapist`
flaman	POST-NOUN	`flaman`
flambe	POST-NOUN	`flambe`
flamenko	POST-NOUN	`flamenko`
flamingo	POST-NOUN	`flamingo`
flaþör	POST-NOUN	`flaþör`
fleol	POST-NOUN	`fleol`
flibit	POST-NOUN	`flibit`
florýþý	POST-NOUN	`florýþý`
florýþýl	POST-NOUN	`florýþýl`
florit	POST-NOUN	`florit`
florür	POST-NOUN	`florür`
florya	POST-NOUN	`florya`
flüoresan	POST-NOUN	`flüoresan`
flüoresans	POST-NOUN	`flüoresans`
fob	POST-NOUN	`fob`
fok	POST-NOUN	`fok`
fokus	POST-NOUN	`fokus`
folk	POST-NOUN	`folk`
folklorist	POST-NOUN	`folklorist`
folyo	POST-NOUN	`folyo`
fonetik	POST-NOUN	`fonetik`
fonksiyonalizm	POST-NOUN	`fonksiyonalizm`
fonolog	POST-NOUN	`fonolog`
fonoloji	POST-NOUN	`fonoloji`
forint	POST-NOUN	`forint`
formalizm	POST-NOUN	`formalizm`
formel	POST-NOUN	`formel`
formen	POST-NOUN	`formen`
formika	POST-NOUN	`formika`
formol	POST-NOUN	`formol`
formüle	POST-NOUN	`formüle`
forsmajör	POST-NOUN	`forsmajör`
foseptik	POST-NOUN	`foseptik`
fosgen	POST-NOUN	`fosgen`
fosurtu	POST-NOUN	`fosurtu`
foþ	POST-NOUN	`foþ`
foþa	POST-NOUN	`foþa`
fotin	POST-NOUN	`fotin`
fotometre	POST-NOUN	`fotometre`
fotometri	POST-NOUN	`fotometri`
fototek	POST-NOUN	`fototek`
fön	POST-NOUN	`fön`
föy	POST-NOUN	`föy`
frape	POST-NOUN	`frape`
frenk	POST-NOUN	`frenk`
frenoloji	POST-NOUN	`frenoloji`
frer	POST-NOUN	`frer`
fresk	POST-NOUN	`fresk`
frijider	POST-NOUN	`frijider`
frijidite	POST-NOUN	`frijidite`
fritöz	POST-NOUN	`fritöz`
friz	POST-NOUN	`friz`
fruktoz	POST-NOUN	`fruktoz`
fujer	POST-NOUN	`fujer`
ful	POST-NOUN	`ful`
ful	POST-NOUN	`ful`
fule	POST-NOUN	`fule`
fundamentalist	POST-NOUN	`fundamentalist`
fundamentalizm	POST-NOUN	`fundamentalizm`
fümerol	POST-NOUN	`fümerol`
fünye	POST-NOUN	`fünye`
fütur	POST-NOUN	`fütur`
fütürolog	POST-NOUN	`fütürolog`
fütüroloji	POST-NOUN	`fütüroloji`
fütüvvet	POST-NOUN	`fütüvvet`
füzesavar	POST-NOUN	`füzesavar`
füzyometre	POST-NOUN	`füzyometre`
gabardin	POST-NOUN	`gabardin`
gabavet	POST-NOUN	`gabavet`
gabyar	POST-NOUN	`gabyar`
gadir	POST-NOUN	`gadir`
gagaburun	POST-NOUN	`gagaburun`
gagavuz	POST-NOUN	`gagavuz`
gak	POST-NOUN	`gak`
galalit	POST-NOUN	`galalit`
galatýhis	POST-NOUN	`galatýhis`
gale	POST-NOUN	`gale`
galop	POST-NOUN	`galop`
galvaniz	POST-NOUN	`galvaniz`
galvanometre	POST-NOUN	`galvanometre`
gamba	POST-NOUN	`gamba`
gamlandýrmak	POST-NOUN	`gamlandýrmak`
gangliyon	POST-NOUN	`gangliyon`
garaip	POST-NOUN	`garaip`
garantör	POST-NOUN	`garantör`
gard	POST-NOUN	`gard`
gardýrop	POST-NOUN	`gardýrop`
gark	POST-NOUN	`gark`
garoz	POST-NOUN	`garoz`
garp	POST-NOUN	`garp`
garp	POST-NOUN	`garp`
garsiyat	POST-NOUN	`garsiyat`
gasil	POST-NOUN	`gasil`
gassal	POST-NOUN	`gassal`
gastroenterolog	POST-NOUN	`gastroenterolog`
gastroenteroloji	POST-NOUN	`gastroenteroloji`
gastronom	POST-NOUN	`gastronom`
gastronomi	POST-NOUN	`gastronomi`
gastroskop	POST-NOUN	`gastroskop`
gastroskopi	POST-NOUN	`gastroskopi`
gaþiy	POST-NOUN	`gaþiy`
gato	POST-NOUN	`gato`
gauss	POST-NOUN	`gauss`
gayr	POST-NOUN	`gayr`
gayrimüslim	POST-NOUN	`gayrimüslim`
gayz	POST-NOUN	`gayz`
gayzer	POST-NOUN	`gayzer`
gayzerit	POST-NOUN	`gayzerit`
gazal	POST-NOUN	`gazal`
gazap	POST-NOUN	`gazap`
gazeki	POST-NOUN	`gazeki`
gazojen	POST-NOUN	`gazojen`
gazolin	POST-NOUN	`gazolin`
gazometre	POST-NOUN	`gazometre`
gazometri	POST-NOUN	`gazometri`
ge	POST-NOUN	`ge`
gecesefasý	POST-NOUN	`gecesefasý`
geçgeç	POST-NOUN	`geçgeç`
geçiþim	POST-NOUN	`geçiþim`
geçit	POST-NOUN	`geçit`
gehgeh	POST-NOUN	`gehgeh`
gelinfeneri	POST-NOUN	`gelinfeneri`
gelinkuþaðý	POST-NOUN	`gelinkuþaðý`
gelinparmaðý	POST-NOUN	`gelinparmaðý`
geliþtirim	POST-NOUN	`geliþtirim`
general	POST-NOUN	`general`
genitif	POST-NOUN	`genitif`
geniz	POST-NOUN	`geniz`
geodezi	POST-NOUN	`geodezi`
geoit	POST-NOUN	`geoit`
geometri	POST-NOUN	`geometri`
gerçek	POST-NOUN	`gerçek`
gerçeküstü	POST-NOUN	`gerçeküstü`
geriatri	POST-NOUN	`geriatri`
geriz	POST-NOUN	`geriz`
germanist	POST-NOUN	`germanist`
germanistik	POST-NOUN	`germanistik`
germanofil	POST-NOUN	`germanofil`
germen	POST-NOUN	`germen`
gerundium	POST-NOUN	`gerundium`
gestapo	POST-NOUN	`gestapo`
getirim	POST-NOUN	`getirim`
getr	POST-NOUN	`getr`
gýdým	POST-NOUN	`gýdým`
gýk	POST-NOUN	`gýk`
gýyap	POST-NOUN	`gýyap`
gýygýy	POST-NOUN	`gýygýy`
gilaburu	POST-NOUN	`gilaburu`
ginseng	POST-NOUN	`ginseng`
giray	POST-NOUN	`giray`
girdap	POST-NOUN	`girdap`
giren	POST-NOUN	`giren`
girim	POST-NOUN	`girim`
giriþimsel	POST-NOUN	`giriþimsel`
giyecek	POST-NOUN	`giyecek`
giyimevi	POST-NOUN	`giyimevi`
glasnost	POST-NOUN	`glasnost`
glasyolog	POST-NOUN	`glasyolog`
glasyoloji	POST-NOUN	`glasyoloji`
glasyolojist	POST-NOUN	`glasyolojist`
globulin	POST-NOUN	`globulin`
gobit	POST-NOUN	`gobit`
godoþ	POST-NOUN	`godoþ`
gol	POST-NOUN	`gol`
golfstrim	POST-NOUN	`golfstrim`
gondol	POST-NOUN	`gondol`
gonokok	POST-NOUN	`gonokok`
göbüt	POST-NOUN	`göbüt`
göç	POST-NOUN	`göç`
göðüs	POST-NOUN	`göðüs`
gökdoðan	POST-NOUN	`gökdoðan`
gökevi	POST-NOUN	`gökevi`
gökgüvercin	POST-NOUN	`gökgüvercin`
gökkuþaðý	POST-NOUN	`gökkuþaðý`
göksoðan	POST-NOUN	`göksoðan`
gökþin	POST-NOUN	`gökþin`
göktýrmalayan	POST-NOUN	`göktýrmalayan`
göktürk	POST-NOUN	`göktürk`
gökyüzü	POST-NOUN	`gökyüzü`
gölalasý	POST-NOUN	`gölalasý`
gölbaþý	POST-NOUN	`gölbaþý`
gölcük	POST-NOUN	`gölcük`
gönderge	POST-NOUN	`gönderge`
gönderim	POST-NOUN	`gönderim`
gönül	POST-NOUN	`gönül`
gönüldaþ	POST-NOUN	`gönüldaþ`
gördürtmek	POST-NOUN	`gördürtmek`
görk	POST-NOUN	`görk`
gösteren	POST-NOUN	`gösteren`
gösterilen	POST-NOUN	`gösterilen`
gösterimde	POST-NOUN	`gösterimde`
gözaltý	POST-NOUN	`gözaltý`
gözdaðý	POST-NOUN	`gözdaðý`
gözdemiri	POST-NOUN	`gözdemiri`
gözetmen	POST-NOUN	`gözetmen`
gözevi	POST-NOUN	`gözevi`
gözgü	POST-NOUN	`gözgü`
gözlemevi	POST-NOUN	`gözlemevi`
gözyaþý	POST-NOUN	`gözyaþý`
graben	POST-NOUN	`graben`
grafolog	POST-NOUN	`grafolog`
grafoloji	POST-NOUN	`grafoloji`
grafometre	POST-NOUN	`grafometre`
gramsantimetre	POST-NOUN	`gramsantimetre`
grandük	POST-NOUN	`grandük`
granit	POST-NOUN	`granit`
granül	POST-NOUN	`granül`
grek	POST-NOUN	`grek`
gren	POST-NOUN	`gren`
greyfurt	POST-NOUN	`greyfurt`
gril	POST-NOUN	`gril`
grip	POST-NOUN	`grip`
grizumetre	POST-NOUN	`grizumetre`
grogi	POST-NOUN	`grogi`
grosa	POST-NOUN	`grosa`
grossmarket	POST-NOUN	`grossmarket`
grotesk	POST-NOUN	`grotesk`
grup	POST-NOUN	`grup`
guaj	POST-NOUN	`guaj`
guarani	POST-NOUN	`guarani`
gulaþ	POST-NOUN	`gulaþ`
gulden	POST-NOUN	`gulden`
gulgule	POST-NOUN	`gulgule`
gurbetzede	POST-NOUN	`gurbetzede`
gurk	POST-NOUN	`gurk`
guru	POST-NOUN	`guru`
gurup	POST-NOUN	`gurup`
gusül	POST-NOUN	`gusül`
gut	POST-NOUN	`gut`
gübür	POST-NOUN	`gübür`
güderihane	POST-NOUN	`güderihane`
gülbahar	POST-NOUN	`gülbahar`
gülbank	POST-NOUN	`gülbank`
gülibriþim	POST-NOUN	`gülibriþim`
gülistan	POST-NOUN	`gülistan`
gülkurusu	POST-NOUN	`gülkurusu`
gülþen	POST-NOUN	`gülþen`
gülüt	POST-NOUN	`gülüt`
gümül	POST-NOUN	`gümül`
gümüþçün	POST-NOUN	`gümüþçün`
gümüþi	POST-NOUN	`gümüþi`
gündüzsefasý	POST-NOUN	`gündüzsefasý`
güneç	POST-NOUN	`güneç`
güneþtopu	POST-NOUN	`güneþtopu`
güney	POST-NOUN	`güney`
güneybalýðý	POST-NOUN	`güneybalýðý`
güneybatý	POST-NOUN	`güneybatý`
güneydoðu	POST-NOUN	`güneydoðu`
güpür	POST-NOUN	`güpür`
gürlek	POST-NOUN	`gürlek`
güvela	POST-NOUN	`güvela`
güvenoyu	POST-NOUN	`güvenoyu`
güvercinboynu	POST-NOUN	`güvercinboynu`
güveyfeneri	POST-NOUN	`güveyfeneri`
güzel	POST-NOUN	`güzel`
hab	POST-NOUN	`hab`
habeþ	POST-NOUN	`habeþ`
habeþi	POST-NOUN	`habeþi`
habitat	POST-NOUN	`habitat`
habitus	POST-NOUN	`habitus`
hacýaða	POST-NOUN	`hacýaða`
hacýlarkuþaðý	POST-NOUN	`hacýlarkuþaðý`
hacim	POST-NOUN	`hacim`
hacir	POST-NOUN	`hacir`
hacivat	POST-NOUN	`hacivat`
haciz	POST-NOUN	`haciz`
haç	POST-NOUN	`haç`
haçvari	POST-NOUN	`haçvari`
had	POST-NOUN	`had`
haddehane	POST-NOUN	`haddehane`
haddikifaye	POST-NOUN	`haddikifaye`
hademeihayrat	POST-NOUN	`hademeihayrat`
hadisat	POST-NOUN	`hadisat`
haf	POST-NOUN	`haf`
hafýzýkütüp	POST-NOUN	`hafýzýkütüp`
hafit	POST-NOUN	`hafit`
hahambaþý	POST-NOUN	`hahambaþý`
haile	POST-NOUN	`haile`
haje	POST-NOUN	`haje`
hakas	POST-NOUN	`hakas`
hakçasý	POST-NOUN	`hakçasý`
hakikat	POST-NOUN	`hakikat`
hakimiyetimilliye	POST-NOUN	`hakimiyetimilliye`
hakkak	POST-NOUN	`hakkak`
hakkýmüktesep	POST-NOUN	`hakkýmüktesep`
hakkýsüküt	POST-NOUN	`hakkýsüküt`
hal	POST-NOUN	`hal`
hal	POST-NOUN	`hal`
hal	POST-NOUN	`hal`
halaç	POST-NOUN	`halaç`
halaskar	POST-NOUN	`halaskar`
halavet	POST-NOUN	`halavet`
halaza	POST-NOUN	`halaza`
halebi	POST-NOUN	`halebi`
haletinez	POST-NOUN	`haletinez`
halhal	POST-NOUN	`halhal`
halile	POST-NOUN	`halile`
halk	POST-NOUN	`halk`
halk	POST-NOUN	`halk`
halkevi	POST-NOUN	`halkevi`
halkiyat	POST-NOUN	`halkiyat`
halkoyu	POST-NOUN	`halkoyu`
halüsinasyon	POST-NOUN	`halüsinasyon`
halvethane	POST-NOUN	`halvethane`
halveti	POST-NOUN	`halveti`
hamakat	POST-NOUN	`hamakat`
hamalbaþý	POST-NOUN	`hamalbaþý`
hamburger	POST-NOUN	`hamburger`
hamdolsun	POST-NOUN	`hamdolsun`
hamdüsena	POST-NOUN	`hamdüsena`
hamel	POST-NOUN	`hamel`
hamýz	POST-NOUN	`hamýz`
hamilikart	POST-NOUN	`hamilikart`
hamsikuþu	POST-NOUN	`hamsikuþu`
hamt	POST-NOUN	`hamt`
hamut	POST-NOUN	`hamut`
hande	POST-NOUN	`hande`
hanefi	POST-NOUN	`hanefi`
hanek	POST-NOUN	`hanek`
hanýmgöbeði	POST-NOUN	`hanýmgöbeði`
hanýmnine	POST-NOUN	`hanýmnine`
hanýmparmaðý	POST-NOUN	`hanýmparmaðý`
hanuman	POST-NOUN	`hanuman`
hanut	POST-NOUN	`hanut`
hanya	POST-NOUN	`hanya`
hapaz	POST-NOUN	`hapaz`
haploit	POST-NOUN	`haploit`
haploloji	POST-NOUN	`haploloji`
haraný	POST-NOUN	`haraný`
haremeyn	POST-NOUN	`haremeyn`
harf	POST-NOUN	`harf`
harfitarif	POST-NOUN	`harfitarif`
harým	POST-NOUN	`harým`
harimiismet	POST-NOUN	`harimiismet`
harir	POST-NOUN	`harir`
hark	POST-NOUN	`hark`
harlak	POST-NOUN	`harlak`
harmaniye	POST-NOUN	`harmaniye`
harmoni	POST-NOUN	`harmoni`
harrup	POST-NOUN	`harrup`
harta	POST-NOUN	`harta`
has	POST-NOUN	`has`
hasa	POST-NOUN	`hasa`
hasat	POST-NOUN	`hasat`
hasbihal	POST-NOUN	`hasbihal`
haset	POST-NOUN	`haset`
hasýlýkelam	POST-NOUN	`hasýlýkelam`
hasým	POST-NOUN	`hasým`
hasýr	POST-NOUN	`hasýr`
hasýr	POST-NOUN	`hasýr`
hasýraltý	POST-NOUN	`hasýraltý`
hasiyet	POST-NOUN	`hasiyet`
hassiyum	POST-NOUN	`hassiyum`
hastahane	POST-NOUN	`hastahane`
hastel	POST-NOUN	`hastel`
haþefe	POST-NOUN	`haþefe`
haþerat	POST-NOUN	`haþerat`
haþhaþhane	POST-NOUN	`haþhaþhane`
haþýrtý	POST-NOUN	`haþýrtý`
haþiv	POST-NOUN	`haþiv`
haþyet	POST-NOUN	`haþyet`
hatif	POST-NOUN	`hatif`
hatim	POST-NOUN	`hatim`
hatip	POST-NOUN	`hatip`
havaalaný	POST-NOUN	`havaalaný`
havalimaný	POST-NOUN	`havalimaný`
havhav	POST-NOUN	`havhav`
havil	POST-NOUN	`havil`
havut	POST-NOUN	`havut`
havuzcuk	POST-NOUN	`havuzcuk`
hayal	POST-NOUN	`hayal`
hayalat	POST-NOUN	`hayalat`
hayalbaz	POST-NOUN	`hayalbaz`
haybe	POST-NOUN	`haybe`
haydut	POST-NOUN	`haydut`
hayýr	POST-NOUN	`hayýr`
hayýrsever	POST-NOUN	`hayýrsever`
hayýz	POST-NOUN	`hayýz`
haykýrtý	POST-NOUN	`haykýrtý`
hayrulhalef	POST-NOUN	`hayrulhalef`
hayta	POST-NOUN	`hayta`
hayvan	POST-NOUN	`hayvan`
hayvancaðýz	POST-NOUN	`hayvancaðýz`
hayvaniyet	POST-NOUN	`hayvaniyet`
hazakat	POST-NOUN	`hazakat`
hazým	POST-NOUN	`hazým`
hazýrun	POST-NOUN	`hazýrun`
hazire	POST-NOUN	`hazire`
hazretleri	POST-NOUN	`hazretleri`
he	POST-NOUN	`he`
heccav	POST-NOUN	`heccav`
hekimbaþý	POST-NOUN	`hekimbaþý`
hektometre	POST-NOUN	`hektometre`
helal	POST-NOUN	`helal`
helen	POST-NOUN	`helen`
helenist	POST-NOUN	`helenist`
helikoit	POST-NOUN	`helikoit`
heliport	POST-NOUN	`heliport`
hellim	POST-NOUN	`hellim`
helmintoloji	POST-NOUN	`helmintoloji`
hemati	POST-NOUN	`hemati`
hematolog	POST-NOUN	`hematolog`
hematoloji	POST-NOUN	`hematoloji`
hemoroit	POST-NOUN	`hemoroit`
hemþirezade	POST-NOUN	`hemþirezade`
hengam	POST-NOUN	`hengam`
hepatoloji	POST-NOUN	`hepatoloji`
hergele	POST-NOUN	`hergele`
herik	POST-NOUN	`herik`
herk	POST-NOUN	`herk`
herke	POST-NOUN	`herke`
hesap	POST-NOUN	`hesap`
hezaren	POST-NOUN	`hezaren`
hezaren	POST-NOUN	`hezaren`
hezliyat	POST-NOUN	`hezliyat`
hýdýrellez	POST-NOUN	`hýdýrellez`
hýfýz	POST-NOUN	`hýfýz`
hýk	POST-NOUN	`hýk`
hýltan	POST-NOUN	`hýltan`
hýltar	POST-NOUN	`hýltar`
hýnk	POST-NOUN	`hýnk`
hýrvat	POST-NOUN	`hýrvat`
hýþýltý	POST-NOUN	`hýþýltý`
hýþým	POST-NOUN	`hýþým`
hýyaraðasý	POST-NOUN	`hýyaraðasý`
hýyarcýl	POST-NOUN	`hýyarcýl`
hýzýr	POST-NOUN	`hýzýr`
hýzýr	POST-NOUN	`hýzýr`
hicap	POST-NOUN	`hicap`
hiciv	POST-NOUN	`hiciv`
hidatit	POST-NOUN	`hidatit`
hidrasit	POST-NOUN	`hidrasit`
hidrat	POST-NOUN	`hidrat`
hidrobiyoloji	POST-NOUN	`hidrobiyoloji`
hidroelektrik	POST-NOUN	`hidroelektrik`
hidrofor	POST-NOUN	`hidrofor`
hidrografi	POST-NOUN	`hidrografi`
hidrojen	POST-NOUN	`hidrojen`
hidrojeoloji	POST-NOUN	`hidrojeoloji`
hidrokarbon	POST-NOUN	`hidrokarbon`
hidrokarbonat	POST-NOUN	`hidrokarbonat`
hidrokarbür	POST-NOUN	`hidrokarbür`
hidroksil	POST-NOUN	`hidroksil`
hidroksit	POST-NOUN	`hidroksit`
hidroliz	POST-NOUN	`hidroliz`
hidrolog	POST-NOUN	`hidrolog`
hidroloji	POST-NOUN	`hidroloji`
hidrometre	POST-NOUN	`hidrometre`
hidrosfer	POST-NOUN	`hidrosfer`
hidroskopi	POST-NOUN	`hidroskopi`
hidrostatik	POST-NOUN	`hidrostatik`
hidroterapi	POST-NOUN	`hidroterapi`
hidrotermal	POST-NOUN	`hidrotermal`
hidrozol	POST-NOUN	`hidrozol`
higrometre	POST-NOUN	`higrometre`
hikem	POST-NOUN	`hikem`
hikemi	POST-NOUN	`hikemi`
hilafýhakikat	POST-NOUN	`hilafýhakikat`
hilal	POST-NOUN	`hilal`
hilat	POST-NOUN	`hilat`
hileiþeriye	POST-NOUN	`hileiþeriye`
hilkat	POST-NOUN	`hilkat`
hilye	POST-NOUN	`hilye`
himen	POST-NOUN	`himen`
hin	POST-NOUN	`hin`
hindolog	POST-NOUN	`hindolog`
hindoloji	POST-NOUN	`hindoloji`
hindu	POST-NOUN	`hindu`
hinterlant	POST-NOUN	`hinterlant`
hinthorozu	POST-NOUN	`hinthorozu`
hiperbol	POST-NOUN	`hiperbol`
hiperboloit	POST-NOUN	`hiperboloit`
hipermarket	POST-NOUN	`hipermarket`
hipertansiyon	POST-NOUN	`hipertansiyon`
hipoderm	POST-NOUN	`hipoderm`
hipofiz	POST-NOUN	`hipofiz`
hipoglisemi	POST-NOUN	`hipoglisemi`
hiposantr	POST-NOUN	`hiposantr`
hipotansiyon	POST-NOUN	`hipotansiyon`
hirfet	POST-NOUN	`hirfet`
hisset	POST-NOUN	`hisset`
hissiselim	POST-NOUN	`hissiselim`
histoloji	POST-NOUN	`histoloji`
hit	POST-NOUN	`hit`
hitap	POST-NOUN	`hitap`
hitit	POST-NOUN	`hitit`
hititolog	POST-NOUN	`hititolog`
hititoloji	POST-NOUN	`hititoloji`
hizip	POST-NOUN	`hizip`
hol	POST-NOUN	`hol`
holigan	POST-NOUN	`holigan`
hona	POST-NOUN	`hona`
horasani	POST-NOUN	`horasani`
hornblent	POST-NOUN	`hornblent`
horozayaðý	POST-NOUN	`horozayaðý`
horozgözü	POST-NOUN	`horozgözü`
horozibiði	POST-NOUN	`horozibiði`
horozibiði	POST-NOUN	`horozibiði`
horozkarasý	POST-NOUN	`horozkarasý`
horst	POST-NOUN	`horst`
hoþhoþ	POST-NOUN	`hoþhoþ`
hoþkuran	POST-NOUN	`hoþkuran`
hotanto	POST-NOUN	`hotanto`
hozan	POST-NOUN	`hozan`
höpürtü	POST-NOUN	`höpürtü`
hristiyan	POST-NOUN	`hristiyan`
huda	POST-NOUN	`huda`
hudut	POST-NOUN	`hudut`
hukuk	POST-NOUN	`hukuk`
hulliyat	POST-NOUN	`hulliyat`
hulul	POST-NOUN	`hulul`
humar	POST-NOUN	`humar`
humor	POST-NOUN	`humor`
hun	POST-NOUN	`hun`
hunnak	POST-NOUN	`hunnak`
hurda	POST-NOUN	`hurda`
hurufi	POST-NOUN	`hurufi`
husuf	POST-NOUN	`husuf`
husul	POST-NOUN	`husul`
husumetkar	POST-NOUN	`husumetkar`
hutut	POST-NOUN	`hutut`
huzurevi	POST-NOUN	`huzurevi`
hüküm	POST-NOUN	`hüküm`
hülasa	POST-NOUN	`hülasa`
hünnap	POST-NOUN	`hünnap`
hürriyetperver	POST-NOUN	`hürriyetperver`
hüryemez	POST-NOUN	`hüryemez`
hüsnühal	POST-NOUN	`hüsnühal`
hüsnühat	POST-NOUN	`hüsnühat`
hüsnükabul	POST-NOUN	`hüsnükabul`
hüsnütalil	POST-NOUN	`hüsnütalil`
hüsnüteveccüh	POST-NOUN	`hüsnüteveccüh`
hüsnüzan	POST-NOUN	`hüsnüzan`
hüsün	POST-NOUN	`hüsün`
hüvelbaki	POST-NOUN	`hüvelbaki`
hüzün	POST-NOUN	`hüzün`
ýðrýp	POST-NOUN	`ýðrýp`
ýlýkçýl	POST-NOUN	`ýlýkçýl`
ýltar	POST-NOUN	`ýltar`
ýr	POST-NOUN	`ýr`
ýrgatbaþý	POST-NOUN	`ýrgatbaþý`
ýrýp	POST-NOUN	`ýrýp`
ýrk	POST-NOUN	`ýrk`
ýrkiyat	POST-NOUN	`ýrkiyat`
ýskarpela	POST-NOUN	`ýskarpela`
ýslahat	POST-NOUN	`ýslahat`
ýslahevi	POST-NOUN	`ýslahevi`
ýstaka	POST-NOUN	`ýstaka`
ýstanbulin	POST-NOUN	`ýstanbulin`
ýstar	POST-NOUN	`ýstar`
ýstýfa	POST-NOUN	`ýstýfa`
ýstýrap	POST-NOUN	`ýstýrap`
ýstýrar	POST-NOUN	`ýstýrar`
ýþýðan	POST-NOUN	`ýþýðan`
ýþýkkesen	POST-NOUN	`ýþýkkesen`
ýþýlak	POST-NOUN	`ýþýlak`
ýþýntý	POST-NOUN	`ýþýntý`
ýþýtým	POST-NOUN	`ýþýtým`
ýþkýn	POST-NOUN	`ýþkýn`
ýtýr	POST-NOUN	`ýtýr`
ýtlak	POST-NOUN	`ýtlak`
ýtrah	POST-NOUN	`ýtrah`
ýttýrat	POST-NOUN	`ýttýrat`
ýydiye	POST-NOUN	`ýydiye`
ýzgara	POST-NOUN	`ýzgara`
ýzgýn	POST-NOUN	`ýzgýn`
ýztýrap	POST-NOUN	`ýztýrap`
ýztýrar	POST-NOUN	`ýztýrar`
iadeiitibar	POST-NOUN	`iadeiitibar`
iadeiziyaret	POST-NOUN	`iadeiziyaret`
ibadetgah	POST-NOUN	`ibadetgah`
ibrani	POST-NOUN	`ibrani`
ibretialem	POST-NOUN	`ibretialem`
ibzal	POST-NOUN	`ibzal`
icap	POST-NOUN	`icap`
icat	POST-NOUN	`icat`
icmal	POST-NOUN	`icmal`
iç	POST-NOUN	`iç`
içecek	POST-NOUN	`içecek`
içirik	POST-NOUN	`içirik`
içit	POST-NOUN	`içit`
içtihat	POST-NOUN	`içtihat`
içtinap	POST-NOUN	`içtinap`
içyaðý	POST-NOUN	`içyaðý`
idadiye	POST-NOUN	`idadiye`
idea	POST-NOUN	`idea`
ideal	POST-NOUN	`ideal`
idealize	POST-NOUN	`idealize`
ideolog	POST-NOUN	`ideolog`
ideoloji	POST-NOUN	`ideoloji`
idol	POST-NOUN	`idol`
ifham	POST-NOUN	`ifham`
ifrað	POST-NOUN	`ifrað`
ifsat	POST-NOUN	`ifsat`
ifta	POST-NOUN	`ifta`
iðbirar	POST-NOUN	`iðbirar`
iðdir	POST-NOUN	`iðdir`
iðfal	POST-NOUN	`iðfal`
iðtinam	POST-NOUN	`iðtinam`
ihkakýhak	POST-NOUN	`ihkakýhak`
ihlal	POST-NOUN	`ihlal`
ihlas	POST-NOUN	`ihlas`
ihlas	POST-NOUN	`ihlas`
ihmal	POST-NOUN	`ihmal`
ihsanýhümayun	POST-NOUN	`ihsanýhümayun`
ihtifal	POST-NOUN	`ihtifal`
ihtilal	POST-NOUN	`ihtilal`
ihtilam	POST-NOUN	`ihtilam`
ihtimal	POST-NOUN	`ihtimal`
ihtiraz	POST-NOUN	`ihtiraz`
ihtisap	POST-NOUN	`ihtisap`
ihtiyar	POST-NOUN	`ihtiyar`
ihtiyar	POST-NOUN	`ihtiyar`
ika	POST-NOUN	`ika`
ikbal	POST-NOUN	`ikbal`
iki	POST-NOUN	`iki`
ikiçifte	POST-NOUN	`ikiçifte`
ikitek	POST-NOUN	`ikitek`
ikmal	POST-NOUN	`ikmal`
ikon	POST-NOUN	`ikon`
iktiran	POST-NOUN	`iktiran`
iktisap	POST-NOUN	`iktisap`
iktisat	POST-NOUN	`iktisat`
ilanýaþk	POST-NOUN	`ilanýaþk`
ilim	POST-NOUN	`ilim`
ilistir	POST-NOUN	`ilistir`
iliþken	POST-NOUN	`iliþken`
ilk	POST-NOUN	`ilk`
ilkel	POST-NOUN	`ilkel`
ilkgüz	POST-NOUN	`ilkgüz`
illiyet	POST-NOUN	`illiyet`
ilmiahlak	POST-NOUN	`ilmiahlak`
ilmihal	POST-NOUN	`ilmihal`
iltihap	POST-NOUN	`iltihap`
iltisak	POST-NOUN	`iltisak`
imal	POST-NOUN	`imal`
imamevi	POST-NOUN	`imamevi`
imamkayýðý	POST-NOUN	`imamkayýðý`
imaniye	POST-NOUN	`imaniye`
imdat	POST-NOUN	`imdat`
imitasyon	POST-NOUN	`imitasyon`
immünoloji	POST-NOUN	`immünoloji`
imrahor	POST-NOUN	`imrahor`
imrenti	POST-NOUN	`imrenti`
imroz	POST-NOUN	`imroz`
imtisal	POST-NOUN	`imtisal`
imtisas	POST-NOUN	`imtisas`
inam	POST-NOUN	`inam`
inat	POST-NOUN	`inat`
incil	POST-NOUN	`incil`
incitilmek	POST-NOUN	`incitilmek`
incizap	POST-NOUN	`incizap`
inç	POST-NOUN	`inç`
indeterminist	POST-NOUN	`indeterminist`
indibindi	POST-NOUN	`indibindi`
indikatör	POST-NOUN	`indikatör`
individüalist	POST-NOUN	`individüalist`
inebolukütüðü	POST-NOUN	`inebolukütüðü`
inekhane	POST-NOUN	`inekhane`
infak	POST-NOUN	`infak`
infial	POST-NOUN	`infial`
infirak	POST-NOUN	`infirak`
infirat	POST-NOUN	`infirat`
informatik	POST-NOUN	`informatik`
ingiliz	POST-NOUN	`ingiliz`
inhibitör	POST-NOUN	`inhibitör`
inhilal	POST-NOUN	`inhilal`
inhimak	POST-NOUN	`inhimak`
inhina	POST-NOUN	`inhina`
ini	POST-NOUN	`ini`
inikat	POST-NOUN	`inikat`
inisyal	POST-NOUN	`inisyal`
inkýlap	POST-NOUN	`inkýlap`
inkýsam	POST-NOUN	`inkýsam`
inkýyat	POST-NOUN	`inkýyat`
inkisarýhayal	POST-NOUN	`inkisarýhayal`
insiraf	POST-NOUN	`insiraf`
insülin	POST-NOUN	`insülin`
inþat	POST-NOUN	`inþat`
inþirah	POST-NOUN	`inþirah`
integral	POST-NOUN	`integral`
intelekt	POST-NOUN	`intelekt`
intelektüalizm	POST-NOUN	`intelektüalizm`
intelijans	POST-NOUN	`intelijans`
interferometre	POST-NOUN	`interferometre`
interferometri	POST-NOUN	`interferometri`
interferon	POST-NOUN	`interferon`
interkinez	POST-NOUN	`interkinez`
interkoneksiyon	POST-NOUN	`interkoneksiyon`
inti	POST-NOUN	`inti`
intibah	POST-NOUN	`intibah`
intifada	POST-NOUN	`intifada`
intiha	POST-NOUN	`intiha`
intihabat	POST-NOUN	`intihabat`
intihal	POST-NOUN	`intihal`
intihap	POST-NOUN	`intihap`
intikal	POST-NOUN	`intikal`
intisap	POST-NOUN	`intisap`
intiþar	POST-NOUN	`intiþar`
inzal	POST-NOUN	`inzal`
ipek	POST-NOUN	`ipek`
ipham	POST-NOUN	`ipham`
ipilti	POST-NOUN	`ipilti`
iptal	POST-NOUN	`iptal`
iptizal	POST-NOUN	`iptizal`
iradýmesel	POST-NOUN	`iradýmesel`
iradiye	POST-NOUN	`iradiye`
iranist	POST-NOUN	`iranist`
iranistik	POST-NOUN	`iranistik`
irap	POST-NOUN	`irap`
irat	POST-NOUN	`irat`
irinti	POST-NOUN	`irinti`
ironi	POST-NOUN	`ironi`
irsal	POST-NOUN	`irsal`
irsiyet	POST-NOUN	`irsiyet`
irþat	POST-NOUN	`irþat`
irtical	POST-NOUN	`irtical`
irtihal	POST-NOUN	`irtihal`
irtikap	POST-NOUN	`irtikap`
irtisam	POST-NOUN	`irtisam`
isa	POST-NOUN	`isa`
isal	POST-NOUN	`isal`
isale	POST-NOUN	`isale`
isevi	POST-NOUN	`isevi`
isfenks	POST-NOUN	`isfenks`
ishal	POST-NOUN	`ishal`
isim	POST-NOUN	`isim`
iskandinav	POST-NOUN	`iskandinav`
iskarpela	POST-NOUN	`iskarpela`
iski	POST-NOUN	`iski`
iskoç	POST-NOUN	`iskoç`
islav	POST-NOUN	`islav`
islavist	POST-NOUN	`islavist`
islavistik	POST-NOUN	`islavistik`
isloven	POST-NOUN	`isloven`
isnat	POST-NOUN	`isnat`
isnobizm	POST-NOUN	`isnobizm`
isot	POST-NOUN	`isot`
ispanyol	POST-NOUN	`ispanyol`
ispatula	POST-NOUN	`ispatula`
ispençhorozu	POST-NOUN	`ispençhorozu`
ispendek	POST-NOUN	`ispendek`
israfil	POST-NOUN	`israfil`
istadya	POST-NOUN	`istadya`
istiane	POST-NOUN	`istiane`
istiap	POST-NOUN	`istiap`
istibat	POST-NOUN	`istibat`
istibdat	POST-NOUN	`istibdat`
istical	POST-NOUN	`istical`
isticvap	POST-NOUN	`isticvap`
istidat	POST-NOUN	`istidat`
istidlal	POST-NOUN	`istidlal`
istifra	POST-NOUN	`istifra`
istifsar	POST-NOUN	`istifsar`
istifsarýhatýr	POST-NOUN	`istifsarýhatýr`
istihale	POST-NOUN	`istihale`
istihbar	POST-NOUN	`istihbar`
istihlak	POST-NOUN	`istihlak`
istihraç	POST-NOUN	`istihraç`
istihsal	POST-NOUN	`istihsal`
istihzar	POST-NOUN	`istihzar`
istikbal	POST-NOUN	`istikbal`
istiklal	POST-NOUN	`istiklal`
istilzam	POST-NOUN	`istilzam`
istim	POST-NOUN	`istim`
istimal	POST-NOUN	`istimal`
istimara	POST-NOUN	`istimara`
istimdat	POST-NOUN	`istimdat`
istimlak	POST-NOUN	`istimlak`
istimna	POST-NOUN	`istimna`
istimrar	POST-NOUN	`istimrar`
istimzaç	POST-NOUN	`istimzaç`
istinas	POST-NOUN	`istinas`
istinat	POST-NOUN	`istinat`
istinatgah	POST-NOUN	`istinatgah`
istintaç	POST-NOUN	`istintaç`
istirahat	POST-NOUN	`istirahat`
istirdat	POST-NOUN	`istirdat`
istiskal	POST-NOUN	`istiskal`
istitrat	POST-NOUN	`istitrat`
istiva	POST-NOUN	`istiva`
istop	POST-NOUN	`istop`
iþar	POST-NOUN	`iþar`
iþba	POST-NOUN	`iþba`
iþbaþý	POST-NOUN	`iþbaþý`
iþgal	POST-NOUN	`iþgal`
iþgaliye	POST-NOUN	`iþgaliye`
iþkal	POST-NOUN	`iþkal`
iþlenti	POST-NOUN	`iþlenti`
iþletmen	POST-NOUN	`iþletmen`
iþleyim	POST-NOUN	`iþleyim`
iþtial	POST-NOUN	`iþtial`
iþtigal	POST-NOUN	`iþtigal`
iþtiha	POST-NOUN	`iþtiha`
iþtihar	POST-NOUN	`iþtihar`
iþtira	POST-NOUN	`iþtira`
iþtirak	POST-NOUN	`iþtirak`
itaat	POST-NOUN	`itaat`
italyan	POST-NOUN	`italyan`
itap	POST-NOUN	`itap`
itburnu	POST-NOUN	`itburnu`
itdirseði	POST-NOUN	`itdirseði`
iteði	POST-NOUN	`iteði`
itenek	POST-NOUN	`itenek`
ithal	POST-NOUN	`ithal`
iti	POST-NOUN	`iti`
itidal	POST-NOUN	`itidal`
itikaf	POST-NOUN	`itikaf`
itikal	POST-NOUN	`itikal`
itikat	POST-NOUN	`itikat`
itila	POST-NOUN	`itila`
itimat	POST-NOUN	`itimat`
itiyat	POST-NOUN	`itiyat`
itkuyruðu	POST-NOUN	`itkuyruðu`
itmam	POST-NOUN	`itmam`
itminan	POST-NOUN	`itminan`
ittifak	POST-NOUN	`ittifak`
ittihat	POST-NOUN	`ittihat`
ittisal	POST-NOUN	`ittisal`
ivaz	POST-NOUN	`ivaz`
iyi	POST-NOUN	`iyi`
iyilikbilmez	POST-NOUN	`iyilikbilmez`
iyodoiyodür	POST-NOUN	`iyodoiyodür`
iyot	POST-NOUN	`iyot`
izafiye	POST-NOUN	`izafiye`
izaleiþüyu	POST-NOUN	`izaleiþüyu`
izamik	POST-NOUN	`izamik`
izazuikram	POST-NOUN	`izazuikram`
izbandut	POST-NOUN	`izbandut`
izin	POST-NOUN	`izin`
izmihlal	POST-NOUN	`izmihlal`
izometri	POST-NOUN	`izometri`
izzetinefis	POST-NOUN	`izzetinefis`
izzetüikram	POST-NOUN	`izzetüikram`
jakoben	POST-NOUN	`jakoben`
jakobenizm	POST-NOUN	`jakobenizm`
jakuzi	POST-NOUN	`jakuzi`
jale	POST-NOUN	`jale`
janr	POST-NOUN	`janr`
japon	POST-NOUN	`japon`
jargon	POST-NOUN	`jargon`
je	POST-NOUN	`je`
jel	POST-NOUN	`jel`
jeloz	POST-NOUN	`jeloz`
jen	POST-NOUN	`jen`
jenerasyon	POST-NOUN	`jenerasyon`
jenerik	POST-NOUN	`jenerik`
jenosit	POST-NOUN	`jenosit`
jeolog	POST-NOUN	`jeolog`
jeoloji	POST-NOUN	`jeoloji`
jeomorfolog	POST-NOUN	`jeomorfolog`
jeomorfoloji	POST-NOUN	`jeomorfoloji`
jeotermi	POST-NOUN	`jeotermi`
jersey	POST-NOUN	`jersey`
jig	POST-NOUN	`jig`
jikle	POST-NOUN	`jikle`
jiklet	POST-NOUN	`jiklet`
jin	POST-NOUN	`jin`
jinekolog	POST-NOUN	`jinekolog`
jinekoloji	POST-NOUN	`jinekoloji`
jogging	POST-NOUN	`jogging`
joker	POST-NOUN	`joker`
jokey	POST-NOUN	`jokey`
jön	POST-NOUN	`jön`
juro	POST-NOUN	`juro`
jüpiter	POST-NOUN	`jüpiter`
kabadayý	POST-NOUN	`kabadayý`
kabahat	POST-NOUN	`kabahat`
kabak	POST-NOUN	`kabak`
kaban	POST-NOUN	`kaban`
kaban	POST-NOUN	`kaban`
kabana	POST-NOUN	`kabana`
kabir	POST-NOUN	`kabir`
kablelmilat	POST-NOUN	`kablelmilat`
kabul	POST-NOUN	`kabul`
kabus	POST-NOUN	`kabus`
kaçak	POST-NOUN	`kaçak`
kaçamak	POST-NOUN	`kaçamak`
kaçamak	POST-NOUN	`kaçamak`
kaçgöç	POST-NOUN	`kaçgöç`
kaçýntý	POST-NOUN	`kaçýntý`
kaçkýn	POST-NOUN	`kaçkýn`
kadehdaþ	POST-NOUN	`kadehdaþ`
kadýnana	POST-NOUN	`kadýnana`
kadýnbudu	POST-NOUN	`kadýnbudu`
kadýncaðýz	POST-NOUN	`kadýncaðýz`
kadýnevi	POST-NOUN	`kadýnevi`
kadýngöbeði	POST-NOUN	`kadýngöbeði`
kadýnnine	POST-NOUN	`kadýnnine`
kadýntuzluðu	POST-NOUN	`kadýntuzluðu`
kadife	POST-NOUN	`kadife`
kadir	POST-NOUN	`kadir`
kadiri	POST-NOUN	`kadiri`
kadiriye	POST-NOUN	`kadiriye`
kadrat	POST-NOUN	`kadrat`
kafadaþ	POST-NOUN	`kafadaþ`
kafatasý	POST-NOUN	`kafatasý`
kafdaðý	POST-NOUN	`kafdaðý`
kafe	POST-NOUN	`kafe`
kafeþantan	POST-NOUN	`kafeþantan`
kafir	POST-NOUN	`kafir`
kafiristan	POST-NOUN	`kafiristan`
kaðýt	POST-NOUN	`kaðýt`
kahýr	POST-NOUN	`kahýr`
kahpe	POST-NOUN	`kahpe`
kahraman	POST-NOUN	`kahraman`
kahverengi	POST-NOUN	`kahverengi`
kak	POST-NOUN	`kak`
kakýntý	POST-NOUN	`kakýntý`
kakum	POST-NOUN	`kakum`
kal	POST-NOUN	`kal`
kal	POST-NOUN	`kal`
kalamata	POST-NOUN	`kalamata`
kalamazo	POST-NOUN	`kalamazo`
kalamin	POST-NOUN	`kalamin`
kalan	POST-NOUN	`kalan`
kalandýr	POST-NOUN	`kalandýr`
kalantor	POST-NOUN	`kalantor`
kalavra	POST-NOUN	`kalavra`
kalavrahane	POST-NOUN	`kalavrahane`
kalayhane	POST-NOUN	`kalayhane`
kalburabastý	POST-NOUN	`kalburabastý`
kaldýran	POST-NOUN	`kaldýran`
kalebent	POST-NOUN	`kalebent`
kalenderi	POST-NOUN	`kalenderi`
kalenderiye	POST-NOUN	`kalenderiye`
kalevra	POST-NOUN	`kalevra`
kalýp	POST-NOUN	`kalýp`
kalibraj	POST-NOUN	`kalibraj`
kalibrasyon	POST-NOUN	`kalibrasyon`
kaliko	POST-NOUN	`kaliko`
kaliptra	POST-NOUN	`kaliptra`
kalite	POST-NOUN	`kalite`
kalorimetre	POST-NOUN	`kalorimetre`
kalorimetri	POST-NOUN	`kalorimetri`
kalotip	POST-NOUN	`kalotip`
kalp	POST-NOUN	`kalp`
kalp	POST-NOUN	`kalp`
kalpazan	POST-NOUN	`kalpazan`
kalsemi	POST-NOUN	`kalsemi`
kalsifikasyon	POST-NOUN	`kalsifikasyon`
kalvenizm	POST-NOUN	`kalvenizm`
kambiyum	POST-NOUN	`kambiyum`
kambur	POST-NOUN	`kambur`
kambura	POST-NOUN	`kambura`
kamçýbaþý	POST-NOUN	`kamçýbaþý`
kamçýkuyruk	POST-NOUN	`kamçýkuyruk`
kamikaze	POST-NOUN	`kamikaze`
kamkaz	POST-NOUN	`kamkaz`
kampüs	POST-NOUN	`kampüs`
kamu	POST-NOUN	`kamu`
kamuoyu	POST-NOUN	`kamuoyu`
kanaat	POST-NOUN	`kanaat`
kanadiyen	POST-NOUN	`kanadiyen`
kanalet	POST-NOUN	`kanalet`
kanat	POST-NOUN	`kanat`
kanatçýk	POST-NOUN	`kanatçýk`
kancabaþ	POST-NOUN	`kancabaþ`
kancýl	POST-NOUN	`kancýl`
kancur	POST-NOUN	`kancur`
kandamlasý	POST-NOUN	`kandamlasý`
kandela	POST-NOUN	`kandela`
kandidoz	POST-NOUN	`kandidoz`
kandilisa	POST-NOUN	`kandilisa`
kanka	POST-NOUN	`kanka`
kanon	POST-NOUN	`kanon`
kanotiye	POST-NOUN	`kanotiye`
kansa	POST-NOUN	`kansa`
kanserojen	POST-NOUN	`kanserojen`
kanseroloji	POST-NOUN	`kanseroloji`
kant	POST-NOUN	`kant`
kantiyane	POST-NOUN	`kantiyane`
kanuniyet	POST-NOUN	`kanuniyet`
kap	POST-NOUN	`kap`
kap	POST-NOUN	`kap`
kap	POST-NOUN	`kap`
kapakçýk	POST-NOUN	`kapakçýk`
kapan	POST-NOUN	`kapan`
kapan	POST-NOUN	`kapan`
kapela	POST-NOUN	`kapela`
kapýkule	POST-NOUN	`kapýkule`
kapital	POST-NOUN	`kapital`
kapitalizasyon	POST-NOUN	`kapitalizasyon`
kapitone	POST-NOUN	`kapitone`
kapnisit	POST-NOUN	`kapnisit`
kapora	POST-NOUN	`kapora`
kapuçin	POST-NOUN	`kapuçin`
kapuçino	POST-NOUN	`kapuçino`
karabakal	POST-NOUN	`karabakal`
karadavar	POST-NOUN	`karadavar`
karadeniz	POST-NOUN	`karadeniz`
karafa	POST-NOUN	`karafa`
karafaki	POST-NOUN	`karafaki`
karagevrek	POST-NOUN	`karagevrek`
karagürgen	POST-NOUN	`karagürgen`
karahalile	POST-NOUN	`karahalile`
karaim	POST-NOUN	`karaim`
karakaþ	POST-NOUN	`karakaþ`
karakavuk	POST-NOUN	`karakavuk`
karakteroloji	POST-NOUN	`karakteroloji`
karakulak	POST-NOUN	`karakulak`
karakulak	POST-NOUN	`karakulak`
karakutu	POST-NOUN	`karakutu`
karambol	POST-NOUN	`karambol`
karamusal	POST-NOUN	`karamusal`
karar	POST-NOUN	`karar`
karasakýz	POST-NOUN	`karasakýz`
karasu	POST-NOUN	`karasu`
karavel	POST-NOUN	`karavel`
karaya	POST-NOUN	`karaya`
karbojen	POST-NOUN	`karbojen`
karbonizasyon	POST-NOUN	`karbonizasyon`
kardaþ	POST-NOUN	`kardaþ`
kardeþkaný	POST-NOUN	`kardeþkaný`
kardinal	POST-NOUN	`kardinal`
kardiyak	POST-NOUN	`kardiyak`
kardiyolog	POST-NOUN	`kardiyolog`
kardiyoloji	POST-NOUN	`kardiyoloji`
kare	POST-NOUN	`kare`
kargabeyni	POST-NOUN	`kargabeyni`
kargaburnu	POST-NOUN	`kargaburnu`
karýk	POST-NOUN	`karýk`
karýk	POST-NOUN	`karýk`
karýn	POST-NOUN	`karýn`
karýncasever	POST-NOUN	`karýncasever`
karýntasý	POST-NOUN	`karýntasý`
kari	POST-NOUN	`kari`
karnýbahar	POST-NOUN	`karnýbahar`
karþý	POST-NOUN	`karþý`
kartela	POST-NOUN	`kartela`
kartezyenizm	POST-NOUN	`kartezyenizm`
kartografya	POST-NOUN	`kartografya`
karton	POST-NOUN	`karton`
kartopu	POST-NOUN	`kartopu`
kartotek	POST-NOUN	`kartotek`
karun	POST-NOUN	`karun`
karun	POST-NOUN	`karun`
karyaðdý	POST-NOUN	`karyaðdý`
karye	POST-NOUN	`karye`
kasap	POST-NOUN	`kasap`
kasar	POST-NOUN	`kasar`
kasýmpatý	POST-NOUN	`kasýmpatý`
kasýntý	POST-NOUN	`kasýntý`
kasýr	POST-NOUN	`kasýr`
kasýt	POST-NOUN	`kasýt`
kasidehan	POST-NOUN	`kasidehan`
kasiyer	POST-NOUN	`kasiyer`
kask	POST-NOUN	`kask`
kaþe	POST-NOUN	`kaþe`
kaþe	POST-NOUN	`kaþe`
kaþe	POST-NOUN	`kaþe`
kaþpusiye	POST-NOUN	`kaþpusiye`
katafalk	POST-NOUN	`katafalk`
katakofti	POST-NOUN	`katakofti`
katalog	POST-NOUN	`katalog`
katamaran	POST-NOUN	`katamaran`
katana	POST-NOUN	`katana`
katavaþya	POST-NOUN	`katavaþya`
katedral	POST-NOUN	`katedral`
kategorize	POST-NOUN	`kategorize`
katýrkuyruðu	POST-NOUN	`katýrkuyruðu`
katýrtýrnaðý	POST-NOUN	`katýrtýrnaðý`
katibe	POST-NOUN	`katibe`
katibiadil	POST-NOUN	`katibiadil`
katil	POST-NOUN	`katil`
katil	POST-NOUN	`katil`
katip	POST-NOUN	`katip`
katranköpüðü	POST-NOUN	`katranköpüðü`
katre	POST-NOUN	`katre`
katrilyon	POST-NOUN	`katrilyon`
kauçuk	POST-NOUN	`kauçuk`
kavait	POST-NOUN	`kavait`
kavala	POST-NOUN	`kavala`
kavat	POST-NOUN	`kavat`
kavil	POST-NOUN	`kavil`
kavilya	POST-NOUN	`kavilya`
kavim	POST-NOUN	`kavim`
kavis	POST-NOUN	`kavis`
kavlaðan	POST-NOUN	`kavlaðan`
kavlükarar	POST-NOUN	`kavlükarar`
kavmiyat	POST-NOUN	`kavmiyat`
kavrak	POST-NOUN	`kavrak`
kavuþtak	POST-NOUN	`kavuþtak`
kavut	POST-NOUN	`kavut`
kayabaþý	POST-NOUN	`kayabaþý`
kayakevi	POST-NOUN	`kayakevi`
kayan	POST-NOUN	`kayan`
kayarto	POST-NOUN	`kayarto`
kaydýihtiyat	POST-NOUN	`kaydýihtiyat`
kayý	POST-NOUN	`kayý`
kayýn	POST-NOUN	`kayýn`
kayýn	POST-NOUN	`kayýn`
kayýnço	POST-NOUN	`kayýnço`
kayýntý	POST-NOUN	`kayýntý`
kayýp	POST-NOUN	`kayýp`
kayýt	POST-NOUN	`kayýt`
kayýt	POST-NOUN	`kayýt`
kaykay	POST-NOUN	`kaykay`
kaymakaltý	POST-NOUN	`kaymakaltý`
kaynar	POST-NOUN	`kaynar`
kayþat	POST-NOUN	`kayþat`
kaytaban	POST-NOUN	`kaytaban`
kayzer	POST-NOUN	`kayzer`
kazandibi	POST-NOUN	`kazandibi`
kazaným	POST-NOUN	`kazaným`
kazayaðý	POST-NOUN	`kazayaðý`
kazayaðý	POST-NOUN	`kazayaðý`
kazayaðý	POST-NOUN	`kazayaðý`
kazazede	POST-NOUN	`kazazede`
kazboku	POST-NOUN	`kazboku`
kazevi	POST-NOUN	`kazevi`
kazgýç	POST-NOUN	`kazgýç`
kazýkazan	POST-NOUN	`kazýkazan`
kazýl	POST-NOUN	`kazýl`
kazým	POST-NOUN	`kazým`
kazýmýk	POST-NOUN	`kazýmýk`
kazkanadý	POST-NOUN	`kazkanadý`
kazolit	POST-NOUN	`kazolit`
ke	POST-NOUN	`ke`
kebap	POST-NOUN	`kebap`
kebere	POST-NOUN	`kebere`
keçiboynuzu	POST-NOUN	`keçiboynuzu`
keçisedefi	POST-NOUN	`keçisedefi`
keçitýrnaðý	POST-NOUN	`keçitýrnaðý`
kediayaðý	POST-NOUN	`kediayaðý`
kedigözü	POST-NOUN	`kedigözü`
kediyaladý	POST-NOUN	`kediyaladý`
kefek	POST-NOUN	`kefek`
kefin	POST-NOUN	`kefin`
kek	POST-NOUN	`kek`
kelamýkadim	POST-NOUN	`kelamýkadim`
kelek	POST-NOUN	`kelek`
kelepir	POST-NOUN	`kelepir`
kelifit	POST-NOUN	`kelifit`
kelimeiþehadet	POST-NOUN	`kelimeiþehadet`
kemal	POST-NOUN	`kemal`
kemaliafiyet	POST-NOUN	`kemaliafiyet`
kemalist	POST-NOUN	`kemalist`
kemalizm	POST-NOUN	`kemalizm`
kement	POST-NOUN	`kement`
kemik	POST-NOUN	`kemik`
kemikçik	POST-NOUN	`kemikçik`
kenar	POST-NOUN	`kenar`
kendinde	POST-NOUN	`kendinde`
kendir	POST-NOUN	`kendir`
kendirik	POST-NOUN	`kendirik`
kenet	POST-NOUN	`kenet`
kengel	POST-NOUN	`kengel`
kental	POST-NOUN	`kental`
kenter	POST-NOUN	`kenter`
kenttaþ	POST-NOUN	`kenttaþ`
kepçeburun	POST-NOUN	`kepçeburun`
ker	POST-NOUN	`ker`
kerde	POST-NOUN	`kerde`
kerh	POST-NOUN	`kerh`
kerkes	POST-NOUN	`kerkes`
kerrake	POST-NOUN	`kerrake`
kerteles	POST-NOUN	`kerteles`
kerti	POST-NOUN	`kerti`
kervanbaþý	POST-NOUN	`kervanbaþý`
kervankýran	POST-NOUN	`kervankýran`
kesat	POST-NOUN	`kesat`
kesel	POST-NOUN	`kesel`
kesen	POST-NOUN	`kesen`
kesimevi	POST-NOUN	`kesimevi`
kesimhane	POST-NOUN	`kesimhane`
kesir	POST-NOUN	`kesir`
kesp	POST-NOUN	`kesp`
kesyapýþtýr	POST-NOUN	`kesyapýþtýr`
keþif	POST-NOUN	`keþif`
ketal	POST-NOUN	`ketal`
keten	POST-NOUN	`keten`
ketenpere	POST-NOUN	`ketenpere`
ketumiyet	POST-NOUN	`ketumiyet`
kevel	POST-NOUN	`kevel`
kevser	POST-NOUN	`kevser`
keyif	POST-NOUN	`keyif`
kezzap	POST-NOUN	`kezzap`
kýç	POST-NOUN	`kýç`
kýçtankara	POST-NOUN	`kýçtankara`
kýðý	POST-NOUN	`kýðý`
kýkýrtý	POST-NOUN	`kýkýrtý`
kýl	POST-NOUN	`kýl`
kýlade	POST-NOUN	`kýlade`
kýlbaz	POST-NOUN	`kýlbaz`
kýlýr	POST-NOUN	`kýlýr`
kýlkapan	POST-NOUN	`kýlkapan`
kýlükal	POST-NOUN	`kýlükal`
kýnýk	POST-NOUN	`kýnýk`
kýpçak	POST-NOUN	`kýpçak`
kýpti	POST-NOUN	`kýpti`
kýraat	POST-NOUN	`kýraat`
kýracak	POST-NOUN	`kýracak`
kýran	POST-NOUN	`kýran`
kýran	POST-NOUN	`kýran`
kýray	POST-NOUN	`kýray`
kýrbaç	POST-NOUN	`kýrbaç`
kýrgýz	POST-NOUN	`kýrgýz`
kýrýtým	POST-NOUN	`kýrýtým`
kýrk	POST-NOUN	`kýrk`
kýrkbudak	POST-NOUN	`kýrkbudak`
kýrkgeçit	POST-NOUN	`kýrkgeçit`
kýrlangýçkuyruðu	POST-NOUN	`kýrlangýçkuyruðu`
kýrmýzý	POST-NOUN	`kýrmýzý`
kýrmýzýçizgi	POST-NOUN	`kýrmýzýçizgi`
kýrmýzýfener	POST-NOUN	`kýrmýzýfener`
kýrpýntý	POST-NOUN	`kýrpýntý`
kýrsal	POST-NOUN	`kýrsal`
kýsa	POST-NOUN	`kýsa`
kýsaltým	POST-NOUN	`kýsaltým`
kýsým	POST-NOUN	`kýsým`
kýsým	POST-NOUN	`kýsým`
kýþýr	POST-NOUN	`kýþýr`
kýtaat	POST-NOUN	`kýtaat`
kýtal	POST-NOUN	`kýtal`
kývrantý	POST-NOUN	`kývrantý`
kýyasýmukassem	POST-NOUN	`kýyasýmukassem`
kýyye	POST-NOUN	`kýyye`
kýzcaðýz	POST-NOUN	`kýzcaðýz`
kýzevi	POST-NOUN	`kýzevi`
kýzýk	POST-NOUN	`kýzýk`
kýzýl	POST-NOUN	`kýzýl`
kýzýlbaþ	POST-NOUN	`kýzýlbaþ`
kýzýlboya	POST-NOUN	`kýzýlboya`
kýzýlcadiþi	POST-NOUN	`kýzýlcadiþi`
kýzýlçam	POST-NOUN	`kýzýlçam`
kýzýlkanat	POST-NOUN	`kýzýlkanat`
kýzýlkurt	POST-NOUN	`kýzýlkurt`
kýzýlsöðüt	POST-NOUN	`kýzýlsöðüt`
kýzkalbi	POST-NOUN	`kýzkalbi`
kibarzade	POST-NOUN	`kibarzade`
kibernetik	POST-NOUN	`kibernetik`
kibir	POST-NOUN	`kibir`
kibutz	POST-NOUN	`kibutz`
kifaf	POST-NOUN	`kifaf`
kifafýnefis	POST-NOUN	`kifafýnefis`
kik	POST-NOUN	`kik`
kildan	POST-NOUN	`kildan`
kilit	POST-NOUN	`kilit`
kilogrammetre	POST-NOUN	`kilogrammetre`
kilot	POST-NOUN	`kilot`
kilüs	POST-NOUN	`kilüs`
kimüs	POST-NOUN	`kimüs`
kipe	POST-NOUN	`kipe`
kireç	POST-NOUN	`kireç`
kiremit	POST-NOUN	`kiremit`
kiremithane	POST-NOUN	`kiremithane`
kiriþhane	POST-NOUN	`kiriþhane`
kit	POST-NOUN	`kit`
kit	POST-NOUN	`kit`
kitabevi	POST-NOUN	`kitabevi`
kitap	POST-NOUN	`kitap`
kitara	POST-NOUN	`kitara`
kivi	POST-NOUN	`kivi`
kivi	POST-NOUN	`kivi`
kiyaset	POST-NOUN	`kiyaset`
klas	POST-NOUN	`klas`
klimatolog	POST-NOUN	`klimatolog`
klimatoloji	POST-NOUN	`klimatoloji`
klinometre	POST-NOUN	`klinometre`
klip	POST-NOUN	`klip`
kliþehane	POST-NOUN	`kliþehane`
klon	POST-NOUN	`klon`
klorometri	POST-NOUN	`klorometri`
klozet	POST-NOUN	`klozet`
koaptör	POST-NOUN	`koaptör`
kocabaþý	POST-NOUN	`kocabaþý`
kocaoðlan	POST-NOUN	`kocaoðlan`
koç	POST-NOUN	`koç`
koç	POST-NOUN	`koç`
koçbaþý	POST-NOUN	`koçbaþý`
koçboynuzu	POST-NOUN	`koçboynuzu`
kodifikasyon	POST-NOUN	`kodifikasyon`
kofra	POST-NOUN	`kofra`
koð	POST-NOUN	`koð`
kohezyon	POST-NOUN	`kohezyon`
kok	POST-NOUN	`kok`
kokainman	POST-NOUN	`kokainman`
kokainomani	POST-NOUN	`kokainomani`
koketri	POST-NOUN	`koketri`
kokimbit	POST-NOUN	`kokimbit`
kokona	POST-NOUN	`kokona`
kokpit	POST-NOUN	`kokpit`
kokurdan	POST-NOUN	`kokurdan`
kolaðasý	POST-NOUN	`kolaðasý`
kolaj	POST-NOUN	`kolaj`
kolay	POST-NOUN	`kolay`
koledok	POST-NOUN	`koledok`
kolesterol	POST-NOUN	`kolesterol`
koloit	POST-NOUN	`koloit`
kolorimetre	POST-NOUN	`kolorimetre`
kolorimetri	POST-NOUN	`kolorimetri`
kolpa	POST-NOUN	`kolpa`
kolpo	POST-NOUN	`kolpo`
koltukbaþý	POST-NOUN	`koltukbaþý`
kom	POST-NOUN	`kom`
komandite	POST-NOUN	`komandite`
komar	POST-NOUN	`komar`
kombi	POST-NOUN	`kombi`
kombine	POST-NOUN	`kombine`
kombiyum	POST-NOUN	`kombiyum`
komot	POST-NOUN	`komot`
kompetitif	POST-NOUN	`kompetitif`
kompilasyon	POST-NOUN	`kompilasyon`
komplikasyon	POST-NOUN	`komplikasyon`
konalga	POST-NOUN	`konalga`
konç	POST-NOUN	`konç`
kondom	POST-NOUN	`kondom`
kondor	POST-NOUN	`kondor`
kondüit	POST-NOUN	`kondüit`
konfigürasyon	POST-NOUN	`konfigürasyon`
konformizm	POST-NOUN	`konformizm`
koniþmento	POST-NOUN	`koniþmento`
konnektör	POST-NOUN	`konnektör`
konsensüs	POST-NOUN	`konsensüs`
konsept	POST-NOUN	`konsept`
konseptüalizm	POST-NOUN	`konseptüalizm`
konsolidasyon	POST-NOUN	`konsolidasyon`
konsolit	POST-NOUN	`konsolit`
konstrüksiyon	POST-NOUN	`konstrüksiyon`
kontekst	POST-NOUN	`kontekst`
konteyner	POST-NOUN	`konteyner`
kontör	POST-NOUN	`kontör`
kontrol	POST-NOUN	`kontrol`
kontrpiye	POST-NOUN	`kontrpiye`
kontrpuan	POST-NOUN	`kontrpuan`
kontuar	POST-NOUN	`kontuar`
kontur	POST-NOUN	`kontur`
kontuvar	POST-NOUN	`kontuvar`
konukevi	POST-NOUN	`konukevi`
konuþu	POST-NOUN	`konuþu`
konveksiyon	POST-NOUN	`konveksiyon`
konvertisör	POST-NOUN	`konvertisör`
koparan	POST-NOUN	`koparan`
kopek	POST-NOUN	`kopek`
kopyalayapýþtýr	POST-NOUN	`kopyalayapýþtýr`
kopye	POST-NOUN	`kopye`
koral	POST-NOUN	`koral`
koramiral	POST-NOUN	`koramiral`
koregraf	POST-NOUN	`koregraf`
koregrafi	POST-NOUN	`koregrafi`
korgeneral	POST-NOUN	`korgeneral`
korida	POST-NOUN	`korida`
korist	POST-NOUN	`korist`
kornea	POST-NOUN	`kornea`
koroner	POST-NOUN	`koroner`
korozyon	POST-NOUN	`korozyon`
korpus	POST-NOUN	`korpus`
korse	POST-NOUN	`korse`
korteks	POST-NOUN	`korteks`
korucuk	POST-NOUN	`korucuk`
korugan	POST-NOUN	`korugan`
korunum	POST-NOUN	`korunum`
kosa	POST-NOUN	`kosa`
kosmos	POST-NOUN	`kosmos`
koster	POST-NOUN	`koster`
koþin	POST-NOUN	`koþin`
kot	POST-NOUN	`kot`
kot	POST-NOUN	`kot`
kot	POST-NOUN	`kot`
koyacak	POST-NOUN	`koyacak`
koycuk	POST-NOUN	`koycuk`
koyungöbeði	POST-NOUN	`koyungöbeði`
koyungözü	POST-NOUN	`koyungözü`
koyunyünü	POST-NOUN	`koyunyünü`
kozmografya	POST-NOUN	`kozmografya`
kozmoloji	POST-NOUN	`kozmoloji`
kök	POST-NOUN	`kök`
kök	POST-NOUN	`kök`
kökboyasý	POST-NOUN	`kökboyasý`
köktürk	POST-NOUN	`köktürk`
kömbe	POST-NOUN	`kömbe`
kömür	POST-NOUN	`kömür`
köpekayasý	POST-NOUN	`köpekayasý`
köpekkuyruðu	POST-NOUN	`köpekkuyruðu`
köpekoðluköpek	POST-NOUN	`köpekoðluköpek`
köprübaþý	POST-NOUN	`köprübaþý`
köprücük	POST-NOUN	`köprücük`
köre	POST-NOUN	`köre`
kösem	POST-NOUN	`kösem`
köstere	POST-NOUN	`köstere`
köþebaþý	POST-NOUN	`köþebaþý`
köþebent	POST-NOUN	`köþebent`
köþk	POST-NOUN	`köþk`
köþker	POST-NOUN	`köþker`
köygöçüren	POST-NOUN	`köygöçüren`
krampon	POST-NOUN	`krampon`
kraniyoloji	POST-NOUN	`kraniyoloji`
krank	POST-NOUN	`krank`
krem	POST-NOUN	`krem`
krepdöþin	POST-NOUN	`krepdöþin`
kreplin	POST-NOUN	`kreplin`
krepsaten	POST-NOUN	`krepsaten`
kriminolog	POST-NOUN	`kriminolog`
kriminoloji	POST-NOUN	`kriminoloji`
kriptolog	POST-NOUN	`kriptolog`
kriptoloji	POST-NOUN	`kriptoloji`
kristal	POST-NOUN	`kristal`
krom	POST-NOUN	`krom`
kronoloji	POST-NOUN	`kronoloji`
kronometre	POST-NOUN	`kronometre`
kroþe	POST-NOUN	`kroþe`
kruton	POST-NOUN	`kruton`
kruvasan	POST-NOUN	`kruvasan`
kruvaziyer	POST-NOUN	`kruvaziyer`
ksenofobi	POST-NOUN	`ksenofobi`
ksiloloji	POST-NOUN	`ksiloloji`
kubbealtý	POST-NOUN	`kubbealtý`
kudümzen	POST-NOUN	`kudümzen`
küfi	POST-NOUN	`küfi`
kuintet	POST-NOUN	`kuintet`
kulaktozu	POST-NOUN	`kulaktozu`
kullap	POST-NOUN	`kullap`
kuluçkahane	POST-NOUN	`kuluçkahane`
kulüp	POST-NOUN	`kulüp`
kulyuç	POST-NOUN	`kulyuç`
kuman	POST-NOUN	`kuman`
kumandý	POST-NOUN	`kumandý`
kumaþ	POST-NOUN	`kumaþ`
kumbaþý	POST-NOUN	`kumbaþý`
kumpir	POST-NOUN	`kumpir`
kumral	POST-NOUN	`kumral`
kumsal	POST-NOUN	`kumsal`
kunduru	POST-NOUN	`kunduru`
kungfu	POST-NOUN	`kungfu`
kuple	POST-NOUN	`kuple`
kur'an	POST-NOUN	`kur'an`
kurander	POST-NOUN	`kurander`
kurbaðazehri	POST-NOUN	`kurbaðazehri`
kurçatovyum	POST-NOUN	`kurçatovyum`
kurþun	POST-NOUN	`kurþun`
kurt	POST-NOUN	`kurt`
kurt	POST-NOUN	`kurt`
kurtaðzý	POST-NOUN	`kurtaðzý`
kurtarým	POST-NOUN	`kurtarým`
kurtayaðý	POST-NOUN	`kurtayaðý`
kurtbaðrý	POST-NOUN	`kurtbaðrý`
kurtkýyan	POST-NOUN	`kurtkýyan`
kurttýrnaðý	POST-NOUN	`kurttýrnaðý`
kurya	POST-NOUN	`kurya`
kuþane	POST-NOUN	`kuþane`
kuþburnu	POST-NOUN	`kuþburnu`
kuþçubaþý	POST-NOUN	`kuþçubaþý`
kuþekmeði	POST-NOUN	`kuþekmeði`
kuþgömü	POST-NOUN	`kuþgömü`
kuþgözü	POST-NOUN	`kuþgözü`
kuþkanadý	POST-NOUN	`kuþkanadý`
kuþlokumu	POST-NOUN	`kuþlokumu`
kuþpalazý	POST-NOUN	`kuþpalazý`
kuþyemi	POST-NOUN	`kuþyemi`
kutup	POST-NOUN	`kutup`
kutur	POST-NOUN	`kutur`
kuut	POST-NOUN	`kuut`
kuvayýmilliye	POST-NOUN	`kuvayýmilliye`
kuver	POST-NOUN	`kuver`
kuvertür	POST-NOUN	`kuvertür`
kuvöz	POST-NOUN	`kuvöz`
kuymak	POST-NOUN	`kuymak`
kuyruksüren	POST-NOUN	`kuyruksüren`
kuyum	POST-NOUN	`kuyum`
kuzay	POST-NOUN	`kuzay`
kuzey	POST-NOUN	`kuzey`
kuzeybatý	POST-NOUN	`kuzeybatý`
kuzeydoðu	POST-NOUN	`kuzeydoðu`
kuzugöbeði	POST-NOUN	`kuzugöbeði`
kuzukulaðý	POST-NOUN	`kuzukulaðý`
küçük	POST-NOUN	`küçük`
küçükayý	POST-NOUN	`küçükayý`
küffar	POST-NOUN	`küffar`
küfür	POST-NOUN	`küfür`
kükürt	POST-NOUN	`kükürt`
küldöken	POST-NOUN	`küldöken`
külhanbeyi	POST-NOUN	`külhanbeyi`
külliyet	POST-NOUN	`külliyet`
kümeleþim	POST-NOUN	`kümeleþim`
kündekari	POST-NOUN	`kündekari`
künk	POST-NOUN	`künk`
küraso	POST-NOUN	`küraso`
küratör	POST-NOUN	`küratör`
kürdilihicazkar	POST-NOUN	`kürdilihicazkar`
kürit	POST-NOUN	`kürit`
kürk	POST-NOUN	`kürk`
kürt	POST-NOUN	`kürt`
küsküt	POST-NOUN	`küsküt`
küsuf	POST-NOUN	`küsuf`
küþüm	POST-NOUN	`küþüm`
kütör	POST-NOUN	`kütör`
lacivert	POST-NOUN	`lacivert`
laçýn	POST-NOUN	`laçýn`
laçka	POST-NOUN	`laçka`
ladin	POST-NOUN	`ladin`
laedriye	POST-NOUN	`laedriye`
lafýz	POST-NOUN	`lafýz`
lafügüzaf	POST-NOUN	`lafügüzaf`
laðýv	POST-NOUN	`laðýv`
lahit	POST-NOUN	`lahit`
lahos	POST-NOUN	`lahos`
lahut	POST-NOUN	`lahut`
laisizm	POST-NOUN	`laisizm`
lak	POST-NOUN	`lak`
lakap	POST-NOUN	`lakap`
lakýrtý	POST-NOUN	`lakýrtý`
laklakiyat	POST-NOUN	`laklakiyat`
lal	POST-NOUN	`lal`
lamaist	POST-NOUN	`lamaist`
lamaizm	POST-NOUN	`lamaizm`
lambada	POST-NOUN	`lambada`
lando	POST-NOUN	`lando`
lapon	POST-NOUN	`lapon`
larghetto	POST-NOUN	`larghetto`
laser	POST-NOUN	`laser`
laski	POST-NOUN	`laski`
lastik	POST-NOUN	`lastik`
lastikotin	POST-NOUN	`lastikotin`
laþe	POST-NOUN	`laþe`
latifundia	POST-NOUN	`latifundia`
latin	POST-NOUN	`latin`
lavantin	POST-NOUN	`lavantin`
lavrensiyum	POST-NOUN	`lavrensiyum`
lavrovit	POST-NOUN	`lavrovit`
lavsonit	POST-NOUN	`lavsonit`
layenkati	POST-NOUN	`layenkati`
laz	POST-NOUN	`laz`
lazanya	POST-NOUN	`lazanya`
lazut	POST-NOUN	`lazut`
le	POST-NOUN	`le`
leasing	POST-NOUN	`leasing`
leb	POST-NOUN	`leb`
lebdeðmez	POST-NOUN	`lebdeðmez`
leçek	POST-NOUN	`leçek`
lef	POST-NOUN	`lef`
leffüneþir	POST-NOUN	`leffüneþir`
lehtar	POST-NOUN	`lehtar`
lejant	POST-NOUN	`lejant`
lejitimist	POST-NOUN	`lejitimist`
lejyoner	POST-NOUN	`lejyoner`
leksikolog	POST-NOUN	`leksikolog`
leksikoloji	POST-NOUN	`leksikoloji`
lenfa	POST-NOUN	`lenfa`
lep	POST-NOUN	`lep`
lerze	POST-NOUN	`lerze`
leþker	POST-NOUN	`leþker`
levanten	POST-NOUN	`levanten`
levanti	POST-NOUN	`levanti`
levazýmat	POST-NOUN	`levazýmat`
levent	POST-NOUN	`levent`
leylaki	POST-NOUN	`leylaki`
leylekgagasý	POST-NOUN	`leylekgagasý`
lezar	POST-NOUN	`lezar`
lezbiyenizm	POST-NOUN	`lezbiyenizm`
lezyon	POST-NOUN	`lezyon`
libero	POST-NOUN	`libero`
liboþ	POST-NOUN	`liboþ`
liet	POST-NOUN	`liet`
lift	POST-NOUN	`lift`
liga	POST-NOUN	`liga`
lignin	POST-NOUN	`lignin`
likide	POST-NOUN	`likide`
likit	POST-NOUN	`likit`
lim	POST-NOUN	`lim`
limaki	POST-NOUN	`limaki`
limnoloji	POST-NOUN	`limnoloji`
limonküfü	POST-NOUN	`limonküfü`
limuzin	POST-NOUN	`limuzin`
linç	POST-NOUN	`linç`
link	POST-NOUN	`link`
link	POST-NOUN	`link`
lisanýhal	POST-NOUN	`lisanýhal`
lisanýmünasip	POST-NOUN	`lisanýmünasip`
lisaniyat	POST-NOUN	`lisaniyat`
lisansiyer	POST-NOUN	`lisansiyer`
litografi	POST-NOUN	`litografi`
litoloji	POST-NOUN	`litoloji`
liyakat	POST-NOUN	`liyakat`
liyan	POST-NOUN	`liyan`
lizol	POST-NOUN	`lizol`
lizöz	POST-NOUN	`lizöz`
logar	POST-NOUN	`logar`
logistik	POST-NOUN	`logistik`
logo	POST-NOUN	`logo`
lohusa	POST-NOUN	`lohusa`
lojik	POST-NOUN	`lojik`
lok	POST-NOUN	`lok`
lokal	POST-NOUN	`lokal`
lokalizasyon	POST-NOUN	`lokalizasyon`
lokosit	POST-NOUN	`lokosit`
lololo	POST-NOUN	`lololo`
london	POST-NOUN	`london`
longoz	POST-NOUN	`longoz`
lort	POST-NOUN	`lort`
lot	POST-NOUN	`lot`
lökoz	POST-NOUN	`lökoz`
lösemit	POST-NOUN	`lösemit`
lugar	POST-NOUN	`lugar`
lunapark	POST-NOUN	`lunapark`
lup	POST-NOUN	`lup`
lustrin	POST-NOUN	`lustrin`
lügat	POST-NOUN	`lügat`
lügol	POST-NOUN	`lügol`
lüknet	POST-NOUN	`lüknet`
lüks	POST-NOUN	`lüks`
lüks	POST-NOUN	`lüks`
lüksmetre	POST-NOUN	`lüksmetre`
lümensaat	POST-NOUN	`lümensaat`
lünet	POST-NOUN	`lünet`
lütuf	POST-NOUN	`lütuf`
lüzucet	POST-NOUN	`lüzucet`
mabat	POST-NOUN	`mabat`
mabet	POST-NOUN	`mabet`
mabeyin	POST-NOUN	`mabeyin`
mabut	POST-NOUN	`mabut`
macar	POST-NOUN	`macar`
maç	POST-NOUN	`maç`
maddiyet	POST-NOUN	`maddiyet`
maden	POST-NOUN	`maden`
mader	POST-NOUN	`mader`
maderzat	POST-NOUN	`maderzat`
mafevk	POST-NOUN	`mafevk`
maganda	POST-NOUN	`maganda`
magnezit	POST-NOUN	`magnezit`
maðribi	POST-NOUN	`maðribi`
maðrip	POST-NOUN	`maðrip`
maðrip	POST-NOUN	`maðrip`
mahal	POST-NOUN	`mahal`
mahana	POST-NOUN	`mahana`
mahbes	POST-NOUN	`mahbes`
mahbube	POST-NOUN	`mahbube`
mahbup	POST-NOUN	`mahbup`
mahfe	POST-NOUN	`mahfe`
mahfel	POST-NOUN	`mahfel`
mahýv	POST-NOUN	`mahýv`
mahiye	POST-NOUN	`mahiye`
mahkükat	POST-NOUN	`mahkükat`
mahküm	POST-NOUN	`mahküm`
mahkümiyet	POST-NOUN	`mahkümiyet`
mahlep	POST-NOUN	`mahlep`
mahlut	POST-NOUN	`mahlut`
mahmude	POST-NOUN	`mahmude`
mahmul	POST-NOUN	`mahmul`
mahra	POST-NOUN	`mahra`
mahrek	POST-NOUN	`mahrek`
mahrut	POST-NOUN	`mahrut`
mahsul	POST-NOUN	`mahsul`
mahsulat	POST-NOUN	`mahsulat`
mahviyet	POST-NOUN	`mahviyet`
mahzar	POST-NOUN	`mahzar`
mai	POST-NOUN	`mai`
main	POST-NOUN	`main`
makabil	POST-NOUN	`makabil`
makadam	POST-NOUN	`makadam`
makarena	POST-NOUN	`makarena`
makaskar	POST-NOUN	`makaskar`
makat	POST-NOUN	`makat`
makedon	POST-NOUN	`makedon`
makferlan	POST-NOUN	`makferlan`
makina	POST-NOUN	`makina`
makosen	POST-NOUN	`makosen`
makromolekül	POST-NOUN	`makromolekül`
maksat	POST-NOUN	`maksat`
maksure	POST-NOUN	`maksure`
makta	POST-NOUN	`makta`
maktel	POST-NOUN	`maktel`
makule	POST-NOUN	`makule`
makyavelizm	POST-NOUN	`makyavelizm`
makyör	POST-NOUN	`makyör`
makyöz	POST-NOUN	`makyöz`
malafa	POST-NOUN	`malafa`
malç	POST-NOUN	`malç`
malihülya	POST-NOUN	`malihülya`
maliki	POST-NOUN	`maliki`
malkoç	POST-NOUN	`malkoç`
maltoz	POST-NOUN	`maltoz`
malumattar	POST-NOUN	`malumattar`
malya	POST-NOUN	`malya`
mamografi	POST-NOUN	`mamografi`
mamulat	POST-NOUN	`mamulat`
manat	POST-NOUN	`manat`
mandagözü	POST-NOUN	`mandagözü`
mandarin	POST-NOUN	`mandarin`
manganin	POST-NOUN	`manganin`
manihaizm	POST-NOUN	`manihaizm`
manipülasyon	POST-NOUN	`manipülasyon`
mano	POST-NOUN	`mano`
manometre	POST-NOUN	`manometre`
mansýp	POST-NOUN	`mansýp`
mantalite	POST-NOUN	`mantalite`
mantarhane	POST-NOUN	`mantarhane`
manti	POST-NOUN	`manti`
manti	POST-NOUN	`manti`
mantinota	POST-NOUN	`mantinota`
manuel	POST-NOUN	`manuel`
manyetometre	POST-NOUN	`manyetometre`
mapushane	POST-NOUN	`mapushane`
maraba	POST-NOUN	`maraba`
marabut	POST-NOUN	`marabut`
marangozhane	POST-NOUN	`marangozhane`
mareþal	POST-NOUN	`mareþal`
marihuana	POST-NOUN	`marihuana`
marinat	POST-NOUN	`marinat`
mark	POST-NOUN	`mark`
marketing	POST-NOUN	`marketing`
markka	POST-NOUN	`markka`
markör	POST-NOUN	`markör`
marksist	POST-NOUN	`marksist`
marksizm	POST-NOUN	`marksizm`
marmelat	POST-NOUN	`marmelat`
maron	POST-NOUN	`maron`
marsývan	POST-NOUN	`marsývan`
martaloz	POST-NOUN	`martaloz`
martolos	POST-NOUN	`martolos`
marufiyet	POST-NOUN	`marufiyet`
mas	POST-NOUN	`mas`
masara	POST-NOUN	`masara`
masat	POST-NOUN	`masat`
masaüstü	POST-NOUN	`masaüstü`
mask	POST-NOUN	`mask`
maskarat	POST-NOUN	`maskarat`
masnu	POST-NOUN	`masnu`
masnuat	POST-NOUN	`masnuat`
masöz	POST-NOUN	`masöz`
maþala	POST-NOUN	`maþala`
maþer	POST-NOUN	`maþer`
maþrýk	POST-NOUN	`maþrýk`
maþuka	POST-NOUN	`maþuka`
matematisyen	POST-NOUN	`matematisyen`
materyal	POST-NOUN	`materyal`
matkap	POST-NOUN	`matkap`
matla	POST-NOUN	`matla`
matlup	POST-NOUN	`matlup`
matriks	POST-NOUN	`matriks`
matruþka	POST-NOUN	`matruþka`
maun	POST-NOUN	`maun`
mavi	POST-NOUN	`mavi`
mavikantaron	POST-NOUN	`mavikantaron`
maviküf	POST-NOUN	`maviküf`
mavra	POST-NOUN	`mavra`
mavruka	POST-NOUN	`mavruka`
mayþor	POST-NOUN	`mayþor`
maytap	POST-NOUN	`maytap`
mazhar	POST-NOUN	`mazhar`
mazohist	POST-NOUN	`mazohist`
mazruf	POST-NOUN	`mazruf`
mazuryum	POST-NOUN	`mazuryum`
meal	POST-NOUN	`meal`
mebzul	POST-NOUN	`mebzul`
mebzuliyet	POST-NOUN	`mebzuliyet`
mecal	POST-NOUN	`mecal`
mecidit	POST-NOUN	`mecidit`
meç	POST-NOUN	`meç`
meç	POST-NOUN	`meç`
meçhul	POST-NOUN	`meçhul`
meçhulat	POST-NOUN	`meçhulat`
medcezir	POST-NOUN	`medcezir`
medet	POST-NOUN	`medet`
medhüsena	POST-NOUN	`medhüsena`
medih	POST-NOUN	`medih`
meditasyon	POST-NOUN	`meditasyon`
medlul	POST-NOUN	`medlul`
mefharet	POST-NOUN	`mefharet`
mefküre	POST-NOUN	`mefküre`
meftuniyet	POST-NOUN	`meftuniyet`
meful	POST-NOUN	`meful`
megaloman	POST-NOUN	`megaloman`
mehabet	POST-NOUN	`mehabet`
mehle	POST-NOUN	`mehle`
mehmetçik	POST-NOUN	`mehmetçik`
mehr	POST-NOUN	`mehr`
mehtap	POST-NOUN	`mehtap`
mehteran	POST-NOUN	`mehteran`
mehterbaþý	POST-NOUN	`mehterbaþý`
mekanizasyon	POST-NOUN	`mekanizasyon`
mekkare	POST-NOUN	`mekkare`
meksefe	POST-NOUN	`meksefe`
mektep	POST-NOUN	`mektep`
mektup	POST-NOUN	`mektup`
melal	POST-NOUN	`melal`
melamet	POST-NOUN	`melamet`
melanit	POST-NOUN	`melanit`
meleküt	POST-NOUN	`meleküt`
melhem	POST-NOUN	`melhem`
memat	POST-NOUN	`memat`
memleha	POST-NOUN	`memleha`
memnu	POST-NOUN	`memnu`
memnuiyet	POST-NOUN	`memnuiyet`
memul	POST-NOUN	`memul`
memure	POST-NOUN	`memure`
men	POST-NOUN	`men`
menafi	POST-NOUN	`menafi`
menafiiumumiye	POST-NOUN	`menafiiumumiye`
menakýp	POST-NOUN	`menakýp`
menecer	POST-NOUN	`menecer`
menejer	POST-NOUN	`menejer`
menengiç	POST-NOUN	`menengiç`
menent	POST-NOUN	`menent`
menfa	POST-NOUN	`menfa`
menfaatperver	POST-NOUN	`menfaatperver`
menfaattar	POST-NOUN	`menfaattar`
menhiyat	POST-NOUN	`menhiyat`
menisk	POST-NOUN	`menisk`
menisküs	POST-NOUN	`menisküs`
menkul	POST-NOUN	`menkul`
menopoz	POST-NOUN	`menopoz`
menþur	POST-NOUN	`menþur`
mentol	POST-NOUN	`mentol`
menü	POST-NOUN	`menü`
menüsküs	POST-NOUN	`menüsküs`
menzile	POST-NOUN	`menzile`
meral	POST-NOUN	`meral`
merbutiyet	POST-NOUN	`merbutiyet`
mercan	POST-NOUN	`mercan`
mercanköþk	POST-NOUN	`mercanköþk`
merdikýpti	POST-NOUN	`merdikýpti`
merdivenevi	POST-NOUN	`merdivenevi`
merdivenkovasý	POST-NOUN	`merdivenkovasý`
merek	POST-NOUN	`merek`
meres	POST-NOUN	`meres`
merih	POST-NOUN	`merih`
merkat	POST-NOUN	`merkat`
merkep	POST-NOUN	`merkep`
merkür	POST-NOUN	`merkür`
mermer	POST-NOUN	`mermer`
mermer	POST-NOUN	`mermer`
mersiyehan	POST-NOUN	`mersiyehan`
meryemanaeldiveni	POST-NOUN	`meryemanaeldiveni`
meryemanakuþaðý	POST-NOUN	`meryemanakuþaðý`
mesabe	POST-NOUN	`mesabe`
mesail	POST-NOUN	`mesail`
mescit	POST-NOUN	`mescit`
mesen	POST-NOUN	`mesen`
meserret	POST-NOUN	`meserret`
mesh	POST-NOUN	`mesh`
mesih	POST-NOUN	`mesih`
meskenet	POST-NOUN	`meskenet`
meskükat	POST-NOUN	`meskükat`
mesnet	POST-NOUN	`mesnet`
meþe	POST-NOUN	`meþe`
meþher	POST-NOUN	`meþher`
meþhet	POST-NOUN	`meþhet`
meþihat	POST-NOUN	`meþihat`
meþk	POST-NOUN	`meþk`
meþrep	POST-NOUN	`meþrep`
meþruiyet	POST-NOUN	`meþruiyet`
meþruta	POST-NOUN	`meþruta`
meþveret	POST-NOUN	`meþveret`
metafor	POST-NOUN	`metafor`
metal	POST-NOUN	`metal`
metaloit	POST-NOUN	`metaloit`
metalürji	POST-NOUN	`metalürji`
meteorolog	POST-NOUN	`meteorolog`
meteoroloji	POST-NOUN	`meteoroloji`
metfen	POST-NOUN	`metfen`
methal	POST-NOUN	`methal`
methüsena	POST-NOUN	`methüsena`
metneryum	POST-NOUN	`metneryum`
metodoloji	POST-NOUN	`metodoloji`
metot	POST-NOUN	`metot`
metroloji	POST-NOUN	`metroloji`
metropol	POST-NOUN	`metropol`
metroseksüel	POST-NOUN	`metroseksüel`
metrukiyet	POST-NOUN	`metrukiyet`
mevcudat	POST-NOUN	`mevcudat`
mevcut	POST-NOUN	`mevcut`
mevhibe	POST-NOUN	`mevhibe`
mevhibeiilahiye	POST-NOUN	`mevhibeiilahiye`
mevize	POST-NOUN	`mevize`
mevkufiyet	POST-NOUN	`mevkufiyet`
mevkute	POST-NOUN	`mevkute`
mevla	POST-NOUN	`mevla`
mevla	POST-NOUN	`mevla`
mevlevi	POST-NOUN	`mevlevi`
mevlevihane	POST-NOUN	`mevlevihane`
mevlit	POST-NOUN	`mevlit`
mevlithan	POST-NOUN	`mevlithan`
mevlut	POST-NOUN	`mevlut`
mevt	POST-NOUN	`mevt`
meydanda	POST-NOUN	`meydanda`
meydani	POST-NOUN	`meydani`
meyil	POST-NOUN	`meyil`
meyusiyet	POST-NOUN	`meyusiyet`
meyyit	POST-NOUN	`meyyit`
mezaristan	POST-NOUN	`mezaristan`
mezat	POST-NOUN	`mezat`
mezellet	POST-NOUN	`mezellet`
mezgit	POST-NOUN	`mezgit`
mezhep	POST-NOUN	`mezhep`
mezmur	POST-NOUN	`mezmur`
mezoterm	POST-NOUN	`mezoterm`
mezozom	POST-NOUN	`mezozom`
mezraa	POST-NOUN	`mezraa`
mezura	POST-NOUN	`mezura`
mýcýr	POST-NOUN	`mýcýr`
mýgri	POST-NOUN	`mýgri`
mýkla	POST-NOUN	`mýkla`
mýklep	POST-NOUN	`mýklep`
mýknatýsiyet	POST-NOUN	`mýknatýsiyet`
mýrmýr	POST-NOUN	`mýrmýr`
mýrra	POST-NOUN	`mýrra`
mýsdak	POST-NOUN	`mýsdak`
mýskal	POST-NOUN	`mýskal`
mýzrap	POST-NOUN	`mýzrap`
mi	POST-NOUN	`mi`
miat	POST-NOUN	`miat`
miçel	POST-NOUN	`miçel`
midibüs	POST-NOUN	`midibüs`
miftah	POST-NOUN	`miftah`
migmatit	POST-NOUN	`migmatit`
mihek	POST-NOUN	`mihek`
mihenk	POST-NOUN	`mihenk`
mihman	POST-NOUN	`mihman`
mihr	POST-NOUN	`mihr`
mihrap	POST-NOUN	`mihrap`
mika	POST-NOUN	`mika`
mikail	POST-NOUN	`mikail`
mikap	POST-NOUN	`mikap`
mikoloji	POST-NOUN	`mikoloji`
mikos	POST-NOUN	`mikos`
mikoz	POST-NOUN	`mikoz`
mikrobiyolog	POST-NOUN	`mikrobiyolog`
mikrobiyoloji	POST-NOUN	`mikrobiyoloji`
mikrocerrahi	POST-NOUN	`mikrocerrahi`
mikrodalga	POST-NOUN	`mikrodalga`
mikrokozmos	POST-NOUN	`mikrokozmos`
mikrometre	POST-NOUN	`mikrometre`
mikrop	POST-NOUN	`mikrop`
milat	POST-NOUN	`milat`
milel	POST-NOUN	`milel`
milimetre	POST-NOUN	`milimetre`
millettaþ	POST-NOUN	`millettaþ`
milletvekilliði	POST-NOUN	`milletvekilliði`
milyar	POST-NOUN	`milyar`
milyarder	POST-NOUN	`milyarder`
milyon	POST-NOUN	`milyon`
milyoner	POST-NOUN	`milyoner`
mimarbaþý	POST-NOUN	`mimarbaþý`
mimber	POST-NOUN	`mimber`
mineral	POST-NOUN	`mineral`
minerolog	POST-NOUN	`minerolog`
mineroloji	POST-NOUN	`mineroloji`
minimetre	POST-NOUN	`minimetre`
mink	POST-NOUN	`mink`
minorka	POST-NOUN	`minorka`
minüskül	POST-NOUN	`minüskül`
minüsküs	POST-NOUN	`minüsküs`
minval	POST-NOUN	`minval`
mir	POST-NOUN	`mir`
mira	POST-NOUN	`mira`
mirat	POST-NOUN	`mirat`
miri	POST-NOUN	`miri`
mirliva	POST-NOUN	`mirliva`
mirza	POST-NOUN	`mirza`
misak	POST-NOUN	`misak`
misal	POST-NOUN	`misal`
misil	POST-NOUN	`misil`
misis	POST-NOUN	`misis`
misk	POST-NOUN	`misk`
miskal	POST-NOUN	`miskal`
mistýr	POST-NOUN	`mistýr`
mitokondri	POST-NOUN	`mitokondri`
mitoloji	POST-NOUN	`mitoloji`
miyane	POST-NOUN	`miyane`
miyav	POST-NOUN	`miyav`
miyom	POST-NOUN	`miyom`
mizantrop	POST-NOUN	`mizantrop`
mnemotekni	POST-NOUN	`mnemotekni`
mobil	POST-NOUN	`mobil`
mobilet	POST-NOUN	`mobilet`
modaevi	POST-NOUN	`modaevi`
modelist	POST-NOUN	`modelist`
modernist	POST-NOUN	`modernist`
modernizasyon	POST-NOUN	`modernizasyon`
modernizm	POST-NOUN	`modernizm`
modul	POST-NOUN	`modul`
moðol	POST-NOUN	`moðol`
moher	POST-NOUN	`moher`
momentum	POST-NOUN	`momentum`
monat	POST-NOUN	`monat`
mongolist	POST-NOUN	`mongolist`
mongolistik	POST-NOUN	`mongolistik`
monokl	POST-NOUN	`monokl`
monolog	POST-NOUN	`monolog`
monopol	POST-NOUN	`monopol`
monoray	POST-NOUN	`monoray`
mont	POST-NOUN	`mont`
montgomer	POST-NOUN	`montgomer`
mor	POST-NOUN	`mor`
moral	POST-NOUN	`moral`
moren	POST-NOUN	`moren`
morfinman	POST-NOUN	`morfinman`
morfoloji	POST-NOUN	`morfoloji`
mormenekþe	POST-NOUN	`mormenekþe`
mortadella	POST-NOUN	`mortadella`
mortgage	POST-NOUN	`mortgage`
moskof	POST-NOUN	`moskof`
motorkros	POST-NOUN	`motorkros`
moymul	POST-NOUN	`moymul`
mozalak	POST-NOUN	`mozalak`
mozerella	POST-NOUN	`mozerella`
muadele	POST-NOUN	`muadele`
muaraza	POST-NOUN	`muaraza`
muare	POST-NOUN	`muare`
muaþaka	POST-NOUN	`muaþaka`
muayede	POST-NOUN	`muayede`
muayyeniyet	POST-NOUN	`muayyeniyet`
mucit	POST-NOUN	`mucit`
mucuk	POST-NOUN	`mucuk`
mudarebe	POST-NOUN	`mudarebe`
muflon	POST-NOUN	`muflon`
mugayeret	POST-NOUN	`mugayeret`
muhaberat	POST-NOUN	`muhaberat`
muhacim	POST-NOUN	`muhacim`
muhaddep	POST-NOUN	`muhaddep`
muhaddis	POST-NOUN	`muhaddis`
muhakkik	POST-NOUN	`muhakkik`
muhammedi	POST-NOUN	`muhammedi`
muharip	POST-NOUN	`muharip`
muhasamat	POST-NOUN	`muhasamat`
muhasým	POST-NOUN	`muhasým`
muhasýr	POST-NOUN	`muhasýr`
muhasip	POST-NOUN	`muhasip`
muhassala	POST-NOUN	`muhassala`
muhassasat	POST-NOUN	`muhassasat`
muhassenat	POST-NOUN	`muhassenat`
muhassýl	POST-NOUN	`muhassýl`
muhatap	POST-NOUN	`muhatap`
muhayyersümbüle	POST-NOUN	`muhayyersümbüle`
muhrip	POST-NOUN	`muhrip`
muhtesip	POST-NOUN	`muhtesip`
muhzýr	POST-NOUN	`muhzýr`
muit	POST-NOUN	`muit`
mukallit	POST-NOUN	`mukallit`
mukarenet	POST-NOUN	`mukarenet`
mukarrerat	POST-NOUN	`mukarrerat`
mukataa	POST-NOUN	`mukataa`
mukayyit	POST-NOUN	`mukayyit`
mukteza	POST-NOUN	`mukteza`
mukus	POST-NOUN	`mukus`
multimedya	POST-NOUN	`multimedya`
multimilyoner	POST-NOUN	`multimilyoner`
mumaileyh	POST-NOUN	`mumaileyh`
mumhane	POST-NOUN	`mumhane`
mumsöndü	POST-NOUN	`mumsöndü`
munsap	POST-NOUN	`munsap`
murabýt	POST-NOUN	`murabýt`
murakýp	POST-NOUN	`murakýp`
murat	POST-NOUN	`murat`
murç	POST-NOUN	`murç`
murt	POST-NOUN	`murt`
musahip	POST-NOUN	`musahip`
musannif	POST-NOUN	`musannif`
musevi	POST-NOUN	`musevi`
mushaf	POST-NOUN	`mushaf`
musikar	POST-NOUN	`musikar`
mustatil	POST-NOUN	`mustatil`
muta	POST-NOUN	`muta`
muta	POST-NOUN	`muta`
mutaf	POST-NOUN	`mutaf`
mutallaka	POST-NOUN	`mutallaka`
mutariza	POST-NOUN	`mutariza`
mutavassýt	POST-NOUN	`mutavassýt`
mutemet	POST-NOUN	`mutemet`
mutezile	POST-NOUN	`mutezile`
mutlakiyet	POST-NOUN	`mutlakiyet`
muvafakat	POST-NOUN	`muvafakat`
muvaffakiyet	POST-NOUN	`muvaffakiyet`
muvakkit	POST-NOUN	`muvakkit`
muvakkithane	POST-NOUN	`muvakkithane`
muvasala	POST-NOUN	`muvasala`
muvaþþah	POST-NOUN	`muvaþþah`
muzafferiyet	POST-NOUN	`muzafferiyet`
mübahase	POST-NOUN	`mübahase`
mübaþeret	POST-NOUN	`mübaþeret`
mübeyyiz	POST-NOUN	`mübeyyiz`
mücahede	POST-NOUN	`mücahede`
mücahit	POST-NOUN	`mücahit`
mücamaa	POST-NOUN	`mücamaa`
mücazat	POST-NOUN	`mücazat`
mücellit	POST-NOUN	`mücellit`
mücellithane	POST-NOUN	`mücellithane`
mücerret	POST-NOUN	`mücerret`
müçtehit	POST-NOUN	`müçtehit`
müdara	POST-NOUN	`müdara`
müdekkik	POST-NOUN	`müdekkik`
müdir	POST-NOUN	`müdir`
müdire	POST-NOUN	`müdire`
müdiriyet	POST-NOUN	`müdiriyet`
müellefat	POST-NOUN	`müellefat`
müessiriyet	POST-NOUN	`müessiriyet`
müfekkire	POST-NOUN	`müfekkire`
müfret	POST-NOUN	`müfret`
müge	POST-NOUN	`müge`
mühendishane	POST-NOUN	`mühendishane`
mühliye	POST-NOUN	`mühliye`
mühre	POST-NOUN	`mühre`
mühresenk	POST-NOUN	`mühresenk`
mührüsüleyman	POST-NOUN	`mührüsüleyman`
mühür	POST-NOUN	`mühür`
müjgan	POST-NOUN	`müjgan`
mükevvenat	POST-NOUN	`mükevvenat`
mükeyyifat	POST-NOUN	`mükeyyifat`
mülayemet	POST-NOUN	`mülayemet`
mülhakat	POST-NOUN	`mülhakat`
mülk	POST-NOUN	`mülk`
mültezim	POST-NOUN	`mültezim`
mümas	POST-NOUN	`mümas`
münadi	POST-NOUN	`münadi`
münakalat	POST-NOUN	`münakalat`
münasebat	POST-NOUN	`münasebat`
mündericat	POST-NOUN	`mündericat`
müneccimbaþý	POST-NOUN	`müneccimbaþý`
münekkit	POST-NOUN	`münekkit`
münteha	POST-NOUN	`münteha`
müntehabat	POST-NOUN	`müntehabat`
müntehip	POST-NOUN	`müntehip`
müradif	POST-NOUN	`müradif`
mürdümük	POST-NOUN	`mürdümük`
mürekkep	POST-NOUN	`mürekkep`
mürettip	POST-NOUN	`mürettip`
mürit	POST-NOUN	`mürit`
mürþit	POST-NOUN	`mürþit`
mürtesem	POST-NOUN	`mürtesem`
müruriye	POST-NOUN	`müruriye`
müsadif	POST-NOUN	`müsadif`
müsakkafat	POST-NOUN	`müsakkafat`
müselles	POST-NOUN	`müselles`
müsellesat	POST-NOUN	`müsellesat`
müsellim	POST-NOUN	`müsellim`
müsemmen	POST-NOUN	`müsemmen`
müsevvit	POST-NOUN	`müsevvit`
müskat	POST-NOUN	`müskat`
müslim	POST-NOUN	`müslim`
müslüman	POST-NOUN	`müslüman`
müstehap	POST-NOUN	`müstehap`
müstehase	POST-NOUN	`müstehase`
müstevi	POST-NOUN	`müstevi`
müstezat	POST-NOUN	`müstezat`
müþahit	POST-NOUN	`müþahit`
müþarünileyh	POST-NOUN	`müþarünileyh`
müþir	POST-NOUN	`müþir`
müþir	POST-NOUN	`müþir`
müþtak	POST-NOUN	`müþtak`
müteahhit	POST-NOUN	`müteahhit`
mütealiye	POST-NOUN	`mütealiye`
mütearife	POST-NOUN	`mütearife`
mütefennin	POST-NOUN	`mütefennin`
müteferrika	POST-NOUN	`müteferrika`
mütekellim	POST-NOUN	`mütekellim`
müttehit	POST-NOUN	`müttehit`
müvellidülhumuza	POST-NOUN	`müvellidülhumuza`
müzaheret	POST-NOUN	`müzaheret`
müzahrefat	POST-NOUN	`müzahrefat`
müzakerat	POST-NOUN	`müzakerat`
müzikal	POST-NOUN	`müzikal`
müzikalite	POST-NOUN	`müzikalite`
müzikhol	POST-NOUN	`müzikhol`
müzikolog	POST-NOUN	`müzikolog`
müzikoloji	POST-NOUN	`müzikoloji`
nabýz	POST-NOUN	`nabýz`
nadirat	POST-NOUN	`nadirat`
nafia	POST-NOUN	`nafia`
nafta	POST-NOUN	`nafta`
nahýr	POST-NOUN	`nahýr`
nahiv	POST-NOUN	`nahiv`
naif	POST-NOUN	`naif`
naip	POST-NOUN	`naip`
nakýz	POST-NOUN	`nakýz`
nakibüleþraf	POST-NOUN	`nakibüleþraf`
nakil	POST-NOUN	`nakil`
nakip	POST-NOUN	`nakip`
nakisa	POST-NOUN	`nakisa`
nakit	POST-NOUN	`nakit`
nakkarhane	POST-NOUN	`nakkarhane`
nakþi	POST-NOUN	`nakþi`
nakþibendi	POST-NOUN	`nakþibendi`
nalan	POST-NOUN	`nalan`
nalbant	POST-NOUN	`nalbant`
nale	POST-NOUN	`nale`
namazbozan	POST-NOUN	`namazbozan`
namazlaðý	POST-NOUN	`namazlaðý`
namzet	POST-NOUN	`namzet`
nan	POST-NOUN	`nan`
nanýaziz	POST-NOUN	`nanýaziz`
nanobakteri	POST-NOUN	`nanobakteri`
nanoteknoloji	POST-NOUN	`nanoteknoloji`
narçiçeði	POST-NOUN	`narçiçeði`
narenç	POST-NOUN	`narenç`
narkozitör	POST-NOUN	`narkozitör`
narval	POST-NOUN	`narval`
narven	POST-NOUN	`narven`
nasfet	POST-NOUN	`nasfet`
nasýp	POST-NOUN	`nasýp`
nasihat	POST-NOUN	`nasihat`
nasip	POST-NOUN	`nasip`
nasir	POST-NOUN	`nasir`
nasrani	POST-NOUN	`nasrani`
nasturi	POST-NOUN	`nasturi`
natür	POST-NOUN	`natür`
natürmort	POST-NOUN	`natürmort`
nazarýdikkat	POST-NOUN	`nazarýdikkat`
nazarýitibar	POST-NOUN	`nazarýitibar`
nazým	POST-NOUN	`nazým`
nazým	POST-NOUN	`nazým`
nazi	POST-NOUN	`nazi`
ne	POST-NOUN	`ne`
nebbaþ	POST-NOUN	`nebbaþ`
necabet	POST-NOUN	`necabet`
necat	POST-NOUN	`necat`
necip	POST-NOUN	`necip`
nedbe	POST-NOUN	`nedbe`
nedim	POST-NOUN	`nedim`
nefha	POST-NOUN	`nefha`
nefis	POST-NOUN	`nefis`
nefiy	POST-NOUN	`nefiy`
nefsaniyet	POST-NOUN	`nefsaniyet`
nehir	POST-NOUN	`nehir`
nehiy	POST-NOUN	`nehiy`
nekahethane	POST-NOUN	`nekahethane`
nekroloji	POST-NOUN	`nekroloji`
nekroz	POST-NOUN	`nekroz`
nemse	POST-NOUN	`nemse`
nene	POST-NOUN	`nene`
neojen	POST-NOUN	`neojen`
neoplatonizm	POST-NOUN	`neoplatonizm`
nepotist	POST-NOUN	`nepotist`
nepotizm	POST-NOUN	`nepotizm`
neptün	POST-NOUN	`neptün`
nere	POST-NOUN	`nere`
nesep	POST-NOUN	`nesep`
nesiç	POST-NOUN	`nesiç`
nesih	POST-NOUN	`nesih`
nesil	POST-NOUN	`nesil`
nesim	POST-NOUN	`nesim`
nesir	POST-NOUN	`nesir`
neþide	POST-NOUN	`neþide`
neþir	POST-NOUN	`neþir`
neuzübillah	POST-NOUN	`neuzübillah`
nev	POST-NOUN	`nev`
nevbahar	POST-NOUN	`nevbahar`
nevir	POST-NOUN	`nevir`
nevrofik	POST-NOUN	`nevrofik`
nevroloji	POST-NOUN	`nevroloji`
nevzat	POST-NOUN	`nevzat`
nezafet	POST-NOUN	`nezafet`
nezahet	POST-NOUN	`nezahet`
nezif	POST-NOUN	`nezif`
nezir	POST-NOUN	`nezir`
nezt	POST-NOUN	`nezt`
nýsfýnnehar	POST-NOUN	`nýsfýnnehar`
nihavent	POST-NOUN	`nihavent`
nikap	POST-NOUN	`nikap`
nikbet	POST-NOUN	`nikbet`
nikel	POST-NOUN	`nikel`
nikris	POST-NOUN	`nikris`
nipel	POST-NOUN	`nipel`
nisa	POST-NOUN	`nisa`
nisap	POST-NOUN	`nisap`
nisyan	POST-NOUN	`nisyan`
niþadýr	POST-NOUN	`niþadýr`
niþangeç	POST-NOUN	`niþangeç`
noel	POST-NOUN	`noel`
nohut	POST-NOUN	`nohut`
nokra	POST-NOUN	`nokra`
noktainazar	POST-NOUN	`noktainazar`
nom	POST-NOUN	`nom`
normal	POST-NOUN	`normal`
normalaltý	POST-NOUN	`normalaltý`
notam	POST-NOUN	`notam`
nova	POST-NOUN	`nova`
nörolog	POST-NOUN	`nörolog`
nöroloji	POST-NOUN	`nöroloji`
nöroþirürji	POST-NOUN	`nöroþirürji`
nöroþirürjiyen	POST-NOUN	`nöroþirürjiyen`
nörotik	POST-NOUN	`nörotik`
nuh	POST-NOUN	`nuh`
nukut	POST-NOUN	`nukut`
nuruayným	POST-NOUN	`nuruayným`
nuruçeþmim	POST-NOUN	`nuruçeþmim`
nurudidem	POST-NOUN	`nurudidem`
nusayri	POST-NOUN	`nusayri`
nutuk	POST-NOUN	`nutuk`
nüdist	POST-NOUN	`nüdist`
nüdizm	POST-NOUN	`nüdizm`
nühüft	POST-NOUN	`nühüft`
nükleik	POST-NOUN	`nükleik`
nükleoprotein	POST-NOUN	`nükleoprotein`
nüks	POST-NOUN	`nüks`
nükül	POST-NOUN	`nükül`
nümismat	POST-NOUN	`nümismat`
nümismatik	POST-NOUN	`nümismatik`
obabaþý	POST-NOUN	`obabaþý`
obartý	POST-NOUN	`obartý`
obelisk	POST-NOUN	`obelisk`
oberj	POST-NOUN	`oberj`
obezite	POST-NOUN	`obezite`
objektivite	POST-NOUN	`objektivite`
observatuvar	POST-NOUN	`observatuvar`
ocakbaþý	POST-NOUN	`ocakbaþý`
ocakeþeði	POST-NOUN	`ocakeþeði`
od	POST-NOUN	`od`
odabaþý	POST-NOUN	`odabaþý`
oduncul	POST-NOUN	`oduncul`
odyometre	POST-NOUN	`odyometre`
ofsayt	POST-NOUN	`ofsayt`
oftalmolog	POST-NOUN	`oftalmolog`
oftalmoloji	POST-NOUN	`oftalmoloji`
oðan	POST-NOUN	`oðan`
oðlanevi	POST-NOUN	`oðlanevi`
oðul	POST-NOUN	`oðul`
ohm	POST-NOUN	`ohm`
ok	POST-NOUN	`ok`
okar	POST-NOUN	`okar`
okazyon	POST-NOUN	`okazyon`
okey	POST-NOUN	`okey`
oksit	POST-NOUN	`oksit`
oksiyür	POST-NOUN	`oksiyür`
okþantý	POST-NOUN	`okþantý`
oktrua	POST-NOUN	`oktrua`
okültizm	POST-NOUN	`okültizm`
okyanusya	POST-NOUN	`okyanusya`
olacak	POST-NOUN	`olacak`
oleometre	POST-NOUN	`oleometre`
olgusal	POST-NOUN	`olgusal`
olmaz	POST-NOUN	`olmaz`
olukçuk	POST-NOUN	`olukçuk`
oluru	POST-NOUN	`oluru`
ombudsman	POST-NOUN	`ombudsman`
omnivor	POST-NOUN	`omnivor`
omuz	POST-NOUN	`omuz`
on	POST-NOUN	`on`
ondülatör	POST-NOUN	`ondülatör`
ongen	POST-NOUN	`ongen`
onkoloji	POST-NOUN	`onkoloji`
onomastik	POST-NOUN	`onomastik`
ontogenez	POST-NOUN	`ontogenez`
ontoloji	POST-NOUN	`ontoloji`
ontolojizm	POST-NOUN	`ontolojizm`
onum	POST-NOUN	`onum`
opal	POST-NOUN	`opal`
opalin	POST-NOUN	`opalin`
oparlör	POST-NOUN	`oparlör`
operatris	POST-NOUN	`operatris`
optimetri	POST-NOUN	`optimetri`
oramiral	POST-NOUN	`oramiral`
orasý	POST-NOUN	`orasý`
orduevi	POST-NOUN	`orduevi`
orfoz	POST-NOUN	`orfoz`
organoleptik	POST-NOUN	`organoleptik`
organtin	POST-NOUN	`organtin`
orgeneral	POST-NOUN	`orgeneral`
ornitolog	POST-NOUN	`ornitolog`
ornitoloji	POST-NOUN	`ornitoloji`
ornitorenk	POST-NOUN	`ornitorenk`
orografya	POST-NOUN	`orografya`
orostopol	POST-NOUN	`orostopol`
orta	POST-NOUN	`orta`
ortodoks	POST-NOUN	`ortodoks`
ortodonti	POST-NOUN	`ortodonti`
oryantal	POST-NOUN	`oryantal`
oryantasyon	POST-NOUN	`oryantasyon`
oryantiring	POST-NOUN	`oryantiring`
osteolog	POST-NOUN	`osteolog`
osteoloji	POST-NOUN	`osteoloji`
otak	POST-NOUN	`otak`
otelgarni	POST-NOUN	`otelgarni`
otist	POST-NOUN	`otist`
otlakiye	POST-NOUN	`otlakiye`
otografi	POST-NOUN	`otografi`
otojestiyon	POST-NOUN	`otojestiyon`
otokontrol	POST-NOUN	`otokontrol`
otoman	POST-NOUN	`otoman`
otopark	POST-NOUN	`otopark`
oturacak	POST-NOUN	`oturacak`
otuz	POST-NOUN	`otuz`
oyalantý	POST-NOUN	`oyalantý`
oymakbaþý	POST-NOUN	`oymakbaþý`
oyuntu	POST-NOUN	`oyuntu`
ozalit	POST-NOUN	`ozalit`
ozonoliz	POST-NOUN	`ozonoliz`
ozonometre	POST-NOUN	`ozonometre`
ozonosfer	POST-NOUN	`ozonosfer`
ozonoskop	POST-NOUN	`ozonoskop`
ozonölçer	POST-NOUN	`ozonölçer`
ozonür	POST-NOUN	`ozonür`
ozuga	POST-NOUN	`ozuga`
öd	POST-NOUN	`öd`
ödiyometre	POST-NOUN	`ödiyometre`
ödyometre	POST-NOUN	`ödyometre`
öge	POST-NOUN	`öge`
öðrek	POST-NOUN	`öðrek`
öðretmenevi	POST-NOUN	`öðretmenevi`
öðüt	POST-NOUN	`öðüt`
öhö	POST-NOUN	`öhö`
öksüzdoyuran	POST-NOUN	`öksüzdoyuran`
öksüzsevindiren	POST-NOUN	`öksüzsevindiren`
öküzburnu	POST-NOUN	`öküzburnu`
öküzgözü	POST-NOUN	`öküzgözü`
ölçülen	POST-NOUN	`ölçülen`
ömrühayat	POST-NOUN	`ömrühayat`
ömür	POST-NOUN	`ömür`
önoloji	POST-NOUN	`önoloji`
ördekbaþý	POST-NOUN	`ördekbaþý`
ördekgagasý	POST-NOUN	`ördekgagasý`
örgen	POST-NOUN	`örgen`
örk	POST-NOUN	`örk`
örük	POST-NOUN	`örük`
örüm	POST-NOUN	`örüm`
öt	POST-NOUN	`öt`
ötanazi	POST-NOUN	`ötanazi`
ötre	POST-NOUN	`ötre`
övünek	POST-NOUN	`övünek`
övüntü	POST-NOUN	`övüntü`
övür	POST-NOUN	`övür`
öz	POST-NOUN	`öz`
öz	POST-NOUN	`öz`
özbek	POST-NOUN	`özbek`
özden	POST-NOUN	`özden`
özeni	POST-NOUN	`özeni`
özlenti	POST-NOUN	`özlenti`
özüt	POST-NOUN	`özüt`
padalya	POST-NOUN	`padalya`
padok	POST-NOUN	`padok`
pahal	POST-NOUN	`pahal`
paladyum	POST-NOUN	`paladyum`
palaspare	POST-NOUN	`palaspare`
paleograf	POST-NOUN	`paleograf`
paleontoloji	POST-NOUN	`paleontoloji`
pancur	POST-NOUN	`pancur`
panda	POST-NOUN	`panda`
panikatak	POST-NOUN	`panikatak`
panslavizm	POST-NOUN	`panslavizm`
pantol	POST-NOUN	`pantol`
papaðanyemi	POST-NOUN	`papaðanyemi`
papalina	POST-NOUN	`papalina`
papaya	POST-NOUN	`papaya`
papazkarasý	POST-NOUN	`papazkarasý`
paprika	POST-NOUN	`paprika`
parabol	POST-NOUN	`parabol`
paraboloit	POST-NOUN	`paraboloit`
paralizi	POST-NOUN	`paralizi`
parametre	POST-NOUN	`parametre`
paramnezi	POST-NOUN	`paramnezi`
parapsikoloji	POST-NOUN	`parapsikoloji`
paratüberküloz	POST-NOUN	`paratüberküloz`
parazitoloji	POST-NOUN	`parazitoloji`
pare	POST-NOUN	`pare`
park	POST-NOUN	`park`
parkmetre	POST-NOUN	`parkmetre`
parnasizm	POST-NOUN	`parnasizm`
parselasyon	POST-NOUN	`parselasyon`
partisip	POST-NOUN	`partisip`
partöner	POST-NOUN	`partöner`
pasata	POST-NOUN	`pasata`
pasifik	POST-NOUN	`pasifik`
pasiyans	POST-NOUN	`pasiyans`
pasör	POST-NOUN	`pasör`
paspartu	POST-NOUN	`paspartu`
pastahane	POST-NOUN	`pastahane`
pastis	POST-NOUN	`pastis`
pastörizasyon	POST-NOUN	`pastörizasyon`
paþababa	POST-NOUN	`paþababa`
paþaçadýrý	POST-NOUN	`paþaçadýrý`
paþazade	POST-NOUN	`paþazade`
patakrem	POST-NOUN	`patakrem`
paternalizm	POST-NOUN	`paternalizm`
patiska	POST-NOUN	`patiska`
patkrem	POST-NOUN	`patkrem`
patlýcani	POST-NOUN	`patlýcani`
patolog	POST-NOUN	`patolog`
patoloji	POST-NOUN	`patoloji`
patoz	POST-NOUN	`patoz`
patpat	POST-NOUN	`patpat`
paunt	POST-NOUN	`paunt`
pavlonya	POST-NOUN	`pavlonya`
payan	POST-NOUN	`payan`
payet	POST-NOUN	`payet`
payreks	POST-NOUN	`payreks`
payton	POST-NOUN	`payton`
pazarbaþý	POST-NOUN	`pazarbaþý`
pazen	POST-NOUN	`pazen`
pazýbent	POST-NOUN	`pazýbent`
pazubent	POST-NOUN	`pazubent`
pe	POST-NOUN	`pe`
peç	POST-NOUN	`peç`
peçenek	POST-NOUN	`peçenek`
pedavra	POST-NOUN	`pedavra`
pediatri	POST-NOUN	`pediatri`
pedodonti	POST-NOUN	`pedodonti`
pedolog	POST-NOUN	`pedolog`
pedolog	POST-NOUN	`pedolog`
pedoloji	POST-NOUN	`pedoloji`
pedoloji	POST-NOUN	`pedoloji`
pedometre	POST-NOUN	`pedometre`
pekent	POST-NOUN	`pekent`
pekmezkefi	POST-NOUN	`pekmezkefi`
pekmezköpüðü	POST-NOUN	`pekmezköpüðü`
pektin	POST-NOUN	`pektin`
pelenk	POST-NOUN	`pelenk`
pelikül	POST-NOUN	`pelikül`
pelit	POST-NOUN	`pelit`
pembekurt	POST-NOUN	`pembekurt`
pembezar	POST-NOUN	`pembezar`
penuvar	POST-NOUN	`penuvar`
perdedar	POST-NOUN	`perdedar`
peren	POST-NOUN	`peren`
perforaj	POST-NOUN	`perforaj`
perforje	POST-NOUN	`perforje`
pergola	POST-NOUN	`pergola`
peridot	POST-NOUN	`peridot`
perikart	POST-NOUN	`perikart`
periyot	POST-NOUN	`periyot`
perküsyon	POST-NOUN	`perküsyon`
perlit	POST-NOUN	`perlit`
perlon	POST-NOUN	`perlon`
permanant	POST-NOUN	`permanant`
permiyen	POST-NOUN	`permiyen`
peroksit	POST-NOUN	`peroksit`
pert	POST-NOUN	`pert`
peruka	POST-NOUN	`peruka`
perukar	POST-NOUN	`perukar`
pervin	POST-NOUN	`pervin`
peso	POST-NOUN	`peso`
peþmelba	POST-NOUN	`peþmelba`
peþtu	POST-NOUN	`peþtu`
petrifikasyon	POST-NOUN	`petrifikasyon`
petrokimya	POST-NOUN	`petrokimya`
petrol	POST-NOUN	`petrol`
petroloji	POST-NOUN	`petroloji`
peyk	POST-NOUN	`peyk`
pýrpýr	POST-NOUN	`pýrpýr`
pýþt	POST-NOUN	`pýþt`
pianta	POST-NOUN	`pianta`
piç	POST-NOUN	`piç`
piçsinek	POST-NOUN	`piçsinek`
pik	POST-NOUN	`pik`
pik	POST-NOUN	`pik`
pik	POST-NOUN	`pik`
pikaj	POST-NOUN	`pikaj`
pikap	POST-NOUN	`pikap`
pike	POST-NOUN	`pike`
pike	POST-NOUN	`pike`
pike	POST-NOUN	`pike`
piknometre	POST-NOUN	`piknometre`
pikolo	POST-NOUN	`pikolo`
pikolo	POST-NOUN	`pikolo`
pile	POST-NOUN	`pile`
piling	POST-NOUN	`piling`
pilotaj	POST-NOUN	`pilotaj`
pipi	POST-NOUN	`pipi`
piramit	POST-NOUN	`piramit`
piramitçik	POST-NOUN	`piramitçik`
pirana	POST-NOUN	`pirana`
pirekýran	POST-NOUN	`pirekýran`
pirifani	POST-NOUN	`pirifani`
piromani	POST-NOUN	`piromani`
pirometre	POST-NOUN	`pirometre`
pirometri	POST-NOUN	`pirometri`
pirpiri	POST-NOUN	`pirpiri`
pirpirim	POST-NOUN	`pirpirim`
pirsing	POST-NOUN	`pirsing`
pisik	POST-NOUN	`pisik`
pisin	POST-NOUN	`pisin`
pislikçil	POST-NOUN	`pislikçil`
pisuvar	POST-NOUN	`pisuvar`
piþdar	POST-NOUN	`piþdar`
piþekar	POST-NOUN	`piþekar`
piþi	POST-NOUN	`piþi`
piþirgeç	POST-NOUN	`piþirgeç`
piþpirik	POST-NOUN	`piþpirik`
piþt	POST-NOUN	`piþt`
pitikare	POST-NOUN	`pitikare`
piyale	POST-NOUN	`piyale`
pizzicato	POST-NOUN	`pizzicato`
planerit	POST-NOUN	`planerit`
planet	POST-NOUN	`planet`
plastik	POST-NOUN	`plastik`
plati	POST-NOUN	`plati`
platin	POST-NOUN	`platin`
platonizm	POST-NOUN	`platonizm`
plaza	POST-NOUN	`plaza`
plöra	POST-NOUN	`plöra`
plüton	POST-NOUN	`plüton`
plütonyum	POST-NOUN	`plütonyum`
plüviyometre	POST-NOUN	`plüviyometre`
podösüet	POST-NOUN	`podösüet`
pogrom	POST-NOUN	`pogrom`
polarimetre	POST-NOUN	`polarimetre`
polarimetri	POST-NOUN	`polarimetri`
polat	POST-NOUN	`polat`
polen	POST-NOUN	`polen`
poliasit	POST-NOUN	`poliasit`
polisevi	POST-NOUN	`polisevi`
polonez	POST-NOUN	`polonez`
polonez	POST-NOUN	`polonez`
pomak	POST-NOUN	`pomak`
pomat	POST-NOUN	`pomat`
pompaj	POST-NOUN	`pompaj`
poplin	POST-NOUN	`poplin`
popo	POST-NOUN	`popo`
popülasyon	POST-NOUN	`popülasyon`
popülist	POST-NOUN	`popülist`
porno	POST-NOUN	`porno`
portal	POST-NOUN	`portal`
portbagaj	POST-NOUN	`portbagaj`
portbebe	POST-NOUN	`portbebe`
portmone	POST-NOUN	`portmone`
portör	POST-NOUN	`portör`
postahane	POST-NOUN	`postahane`
postmodernizm	POST-NOUN	`postmodernizm`
poþet	POST-NOUN	`poþet`
potrel	POST-NOUN	`potrel`
poy	POST-NOUN	`poy`
pozitonyum	POST-NOUN	`pozitonyum`
pöç	POST-NOUN	`pöç`
pöçük	POST-NOUN	`pöçük`
pöhrenk	POST-NOUN	`pöhrenk`
pötibör	POST-NOUN	`pötibör`
pötifur	POST-NOUN	`pötifur`
pragmatik	POST-NOUN	`pragmatik`
prediksiyon	POST-NOUN	`prediksiyon`
prefabrike	POST-NOUN	`prefabrike`
prelüt	POST-NOUN	`prelüt`
prensip	POST-NOUN	`prensip`
preparat	POST-NOUN	`preparat`
prezantasyon	POST-NOUN	`prezantasyon`
prezidyum	POST-NOUN	`prezidyum`
print	POST-NOUN	`print`
printer	POST-NOUN	`printer`
profiterol	POST-NOUN	`profiterol`
prolog	POST-NOUN	`prolog`
promil	POST-NOUN	`promil`
promosyon	POST-NOUN	`promosyon`
promönat	POST-NOUN	`promönat`
protokol	POST-NOUN	`protokol`
providansiyalizm	POST-NOUN	`providansiyalizm`
prozodi	POST-NOUN	`prozodi`
psikiyatrist	POST-NOUN	`psikiyatrist`
psikolog	POST-NOUN	`psikolog`
psikoloji	POST-NOUN	`psikoloji`
psikometri	POST-NOUN	`psikometri`
psikopatoloji	POST-NOUN	`psikopatoloji`
psikoterapi	POST-NOUN	`psikoterapi`
ptiyalin	POST-NOUN	`ptiyalin`
pul	POST-NOUN	`pul`
pulman	POST-NOUN	`pulman`
punt	POST-NOUN	`punt`
pusval	POST-NOUN	`pusval`
pür	POST-NOUN	`pür`
püren	POST-NOUN	`püren`
pürist	POST-NOUN	`pürist`
pürizm	POST-NOUN	`pürizm`
püskülcük	POST-NOUN	`püskülcük`
püstül	POST-NOUN	`püstül`
rab	POST-NOUN	`rab`
rabbena	POST-NOUN	`rabbena`
rabýt	POST-NOUN	`rabýt`
radika	POST-NOUN	`radika`
radyoaktivite	POST-NOUN	`radyoaktivite`
radyobiyoloji	POST-NOUN	`radyobiyoloji`
radyoelektrik	POST-NOUN	`radyoelektrik`
radyoelektronik	POST-NOUN	`radyoelektronik`
radyoevi	POST-NOUN	`radyoevi`
radyofizik	POST-NOUN	`radyofizik`
radyofizyoloji	POST-NOUN	`radyofizyoloji`
radyofoto	POST-NOUN	`radyofoto`
radyografi	POST-NOUN	`radyografi`
radyogram	POST-NOUN	`radyogram`
radyoizotop	POST-NOUN	`radyoizotop`
radyokimya	POST-NOUN	`radyokimya`
radyolink	POST-NOUN	`radyolink`
radyolog	POST-NOUN	`radyolog`
radyoloji	POST-NOUN	`radyoloji`
radyometre	POST-NOUN	`radyometre`
radyometri	POST-NOUN	`radyometri`
radyoskopi	POST-NOUN	`radyoskopi`
radyoteknoloji	POST-NOUN	`radyoteknoloji`
radyotelefon	POST-NOUN	`radyotelefon`
radyotelgraf	POST-NOUN	`radyotelgraf`
radyoterapi	POST-NOUN	`radyoterapi`
radyum	POST-NOUN	`radyum`
rafýzi	POST-NOUN	`rafýzi`
rafinatör	POST-NOUN	`rafinatör`
rafting	POST-NOUN	`rafting`
rafya	POST-NOUN	`rafya`
ragbi	POST-NOUN	`ragbi`
rahat	POST-NOUN	`rahat`
rahim	POST-NOUN	`rahim`
rahim	POST-NOUN	`rahim`
rahip	POST-NOUN	`rahip`
rahleitedris	POST-NOUN	`rahleitedris`
raht	POST-NOUN	`raht`
rakibe	POST-NOUN	`rakibe`
rakun	POST-NOUN	`rakun`
rambo	POST-NOUN	`rambo`
rambursman	POST-NOUN	`rambursman`
ramp	POST-NOUN	`ramp`
randevuevi	POST-NOUN	`randevuevi`
rantiye	POST-NOUN	`rantiye`
rasat	POST-NOUN	`rasat`
rasýt	POST-NOUN	`rasýt`
rasyon	POST-NOUN	`rasyon`
raþe	POST-NOUN	`raþe`
raþi	POST-NOUN	`raþi`
rate	POST-NOUN	`rate`
rating	POST-NOUN	`rating`
raunt	POST-NOUN	`raunt`
ravent	POST-NOUN	`ravent`
razmol	POST-NOUN	`razmol`
reaktif	POST-NOUN	`reaktif`
rebabi	POST-NOUN	`rebabi`
rebap	POST-NOUN	`rebap`
rebiyülahir	POST-NOUN	`rebiyülahir`
recep	POST-NOUN	`recep`
recim	POST-NOUN	`recim`
reçina	POST-NOUN	`reçina`
redevans	POST-NOUN	`redevans`
redüksiyon	POST-NOUN	`redüksiyon`
reeksport	POST-NOUN	`reeksport`
reenkarnasyon	POST-NOUN	`reenkarnasyon`
refakat	POST-NOUN	`refakat`
refik	POST-NOUN	`refik`
reftiye	POST-NOUN	`reftiye`
refüj	POST-NOUN	`refüj`
reha	POST-NOUN	`reha`
reiber	POST-NOUN	`reiber`
reisülküttap	POST-NOUN	`reisülküttap`
rekaket	POST-NOUN	`rekaket`
rekiz	POST-NOUN	`rekiz`
rekonstrüksiyon	POST-NOUN	`rekonstrüksiyon`
rekreasyon	POST-NOUN	`rekreasyon`
rembetiko	POST-NOUN	`rembetiko`
remi	POST-NOUN	`remi`
remiz	POST-NOUN	`remiz`
repertuvar	POST-NOUN	`repertuvar`
repo	POST-NOUN	`repo`
resesyon	POST-NOUN	`resesyon`
resim	POST-NOUN	`resim`
resital	POST-NOUN	`resital`
resmigeçit	POST-NOUN	`resmigeçit`
resmikabul	POST-NOUN	`resmikabul`
restitüsyon	POST-NOUN	`restitüsyon`
resul	POST-NOUN	`resul`
resülmal	POST-NOUN	`resülmal`
ret	POST-NOUN	`ret`
revakiye	POST-NOUN	`revakiye`
revalüasyon	POST-NOUN	`revalüasyon`
revize	POST-NOUN	`revize`
reybi	POST-NOUN	`reybi`
reyhan	POST-NOUN	`reyhan`
reyhani	POST-NOUN	`reyhani`
rezeksiyon	POST-NOUN	`rezeksiyon`
rezervuar	POST-NOUN	`rezervuar`
rýhdan	POST-NOUN	`rýhdan`
rýzýk	POST-NOUN	`rýzýk`
rical	POST-NOUN	`rical`
rika	POST-NOUN	`rika`
rikaptar	POST-NOUN	`rikaptar`
rikkat	POST-NOUN	`rikkat`
rint	POST-NOUN	`rint`
risk	POST-NOUN	`risk`
ritim	POST-NOUN	`ritim`
ritüel	POST-NOUN	`ritüel`
riyazet	POST-NOUN	`riyazet`
riyazi	POST-NOUN	`riyazi`
riyaziye	POST-NOUN	`riyaziye`
robotik	POST-NOUN	`robotik`
rodaj	POST-NOUN	`rodaj`
rol	POST-NOUN	`rol`
romanist	POST-NOUN	`romanist`
romanolog	POST-NOUN	`romanolog`
romanoloji	POST-NOUN	`romanoloji`
romen	POST-NOUN	`romen`
rondela	POST-NOUN	`rondela`
rop	POST-NOUN	`rop`
ropdöþambýr	POST-NOUN	`ropdöþambýr`
rotil	POST-NOUN	`rotil`
roze	POST-NOUN	`roze`
röfle	POST-NOUN	`röfle`
rögar	POST-NOUN	`rögar`
rölans	POST-NOUN	`rölans`
rölativist	POST-NOUN	`rölativist`
römork	POST-NOUN	`römork`
rönesans	POST-NOUN	`rönesans`
röportör	POST-NOUN	`röportör`
ruentgeniyum	POST-NOUN	`ruentgeniyum`
ruf	POST-NOUN	`ruf`
rufai	POST-NOUN	`rufai`
rugan	POST-NOUN	`rugan`
ruhaniyet	POST-NOUN	`ruhaniyet`
ruhbaniyet	POST-NOUN	`ruhbaniyet`
rujlamak	POST-NOUN	`rujlamak`
rum	POST-NOUN	`rum`
rumen	POST-NOUN	`rumen`
run	POST-NOUN	`run`
rupi	POST-NOUN	`rupi`
rus	POST-NOUN	`rus`
rustai	POST-NOUN	`rustai`
rustik	POST-NOUN	`rustik`
rutherfordyum	POST-NOUN	`rutherfordyum`
ruz	POST-NOUN	`ruz`
rübap	POST-NOUN	`rübap`
rüçhan	POST-NOUN	`rüçhan`
rüesa	POST-NOUN	`rüesa`
rüfeka	POST-NOUN	`rüfeka`
rükün	POST-NOUN	`rükün`
rün	POST-NOUN	`rün`
rüsup	POST-NOUN	`rüsup`
rüþeym	POST-NOUN	`rüþeym`
rüzgarölçer	POST-NOUN	`rüzgarölçer`
saadethane	POST-NOUN	`saadethane`
saat	POST-NOUN	`saat`
sabahyýldýzý	POST-NOUN	`sabahyýldýzý`
sabýr	POST-NOUN	`sabýr`
sabuh	POST-NOUN	`sabuh`
sac	POST-NOUN	`sac`
sacayaðý	POST-NOUN	`sacayaðý`
saç	POST-NOUN	`saç`
sada	POST-NOUN	`sada`
sadakat	POST-NOUN	`sadakat`
sadet	POST-NOUN	`sadet`
sadýr	POST-NOUN	`sadýr`
safa	POST-NOUN	`safa`
safari	POST-NOUN	`safari`
safer	POST-NOUN	`safer`
safiyet	POST-NOUN	`safiyet`
sagar	POST-NOUN	`sagar`
sað	POST-NOUN	`sað`
saðkol	POST-NOUN	`saðkol`
saðlýkevi	POST-NOUN	`saðlýkevi`
sah	POST-NOUN	`sah`
sahabet	POST-NOUN	`sahabet`
sahife	POST-NOUN	`sahife`
sahip	POST-NOUN	`sahip`
sahipkýran	POST-NOUN	`sahipkýran`
sahlep	POST-NOUN	`sahlep`
sahn	POST-NOUN	`sahn`
sahre	POST-NOUN	`sahre`
sak	POST-NOUN	`sak`
sakaf	POST-NOUN	`sakaf`
sakamet	POST-NOUN	`sakamet`
sakarimetre	POST-NOUN	`sakarimetre`
sakarimetri	POST-NOUN	`sakarimetri`
sake	POST-NOUN	`sake`
sakýným	POST-NOUN	`sakýným`
sakýrtý	POST-NOUN	`sakýrtý`
saki	POST-NOUN	`saki`
sakkarometre	POST-NOUN	`sakkarometre`
sakkaroz	POST-NOUN	`sakkaroz`
sakkarozölçer	POST-NOUN	`sakkarozölçer`
sako	POST-NOUN	`sako`
saksafon	POST-NOUN	`saksafon`
sakuleta	POST-NOUN	`sakuleta`
salabet	POST-NOUN	`salabet`
salacak	POST-NOUN	`salacak`
salat	POST-NOUN	`salat`
salatüselam	POST-NOUN	`salatüselam`
salep	POST-NOUN	`salep`
salip	POST-NOUN	`salip`
salsa	POST-NOUN	`salsa`
salto	POST-NOUN	`salto`
salur	POST-NOUN	`salur`
samanuðrusu	POST-NOUN	`samanuðrusu`
sami	POST-NOUN	`sami`
samsun	POST-NOUN	`samsun`
samuray	POST-NOUN	`samuray`
sanatevi	POST-NOUN	`sanatevi`
sanayiinefise	POST-NOUN	`sanayiinefise`
sandöviç	POST-NOUN	`sandöviç`
sandviç	POST-NOUN	`sandviç`
sanskrit	POST-NOUN	`sanskrit`
santigrat	POST-NOUN	`santigrat`
santimantalite	POST-NOUN	`santimantalite`
santimantalizm	POST-NOUN	`santimantalizm`
santimetre	POST-NOUN	`santimetre`
santral	POST-NOUN	`santral`
sapan	POST-NOUN	`sapan`
saparta	POST-NOUN	`saparta`
sapsarý	POST-NOUN	`sapsarý`
saptaným	POST-NOUN	`saptaným`
saraciye	POST-NOUN	`saraciye`
sarahat	POST-NOUN	`sarahat`
sarak	POST-NOUN	`sarak`
sarartý	POST-NOUN	`sarartý`
sarat	POST-NOUN	`sarat`
saraypatý	POST-NOUN	`saraypatý`
sarban	POST-NOUN	`sarban`
sarbanbaþý	POST-NOUN	`sarbanbaþý`
sarý	POST-NOUN	`sarý`
sarýaðý	POST-NOUN	`sarýaðý`
sarýaðýz	POST-NOUN	`sarýaðýz`
sarýçiçek	POST-NOUN	`sarýçiçek`
sarýçiðdem	POST-NOUN	`sarýçiðdem`
sarýdiken	POST-NOUN	`sarýdiken`
sarýerik	POST-NOUN	`sarýerik`
sarýfið	POST-NOUN	`sarýfið`
sarýhalile	POST-NOUN	`sarýhalile`
sarýhani	POST-NOUN	`sarýhani`
sarýkanat	POST-NOUN	`sarýkanat`
sarýkýz	POST-NOUN	`sarýkýz`
sarýkuyruk	POST-NOUN	`sarýkuyruk`
sarýpapatya	POST-NOUN	`sarýpapatya`
sarýzambak	POST-NOUN	`sarýzambak`
sarig	POST-NOUN	`sarig`
sarpi	POST-NOUN	`sarpi`
satanizm	POST-NOUN	`satanizm`
satý	POST-NOUN	`satý`
satýh	POST-NOUN	`satýh`
satrap	POST-NOUN	`satrap`
satürn	POST-NOUN	`satürn`
satvet	POST-NOUN	`satvet`
savlet	POST-NOUN	`savlet`
savruntu	POST-NOUN	`savruntu`
say	POST-NOUN	`say`
say	POST-NOUN	`say`
sayeban	POST-NOUN	`sayeban`
sayýsal	POST-NOUN	`sayýsal`
sayrýlarevi	POST-NOUN	`sayrýlarevi`
sazak	POST-NOUN	`sazak`
sazevi	POST-NOUN	`sazevi`
sazkar	POST-NOUN	`sazkar`
sazkayasý	POST-NOUN	`sazkayasý`
sebep	POST-NOUN	`sebep`
sebkihindi	POST-NOUN	`sebkihindi`
sebzevat	POST-NOUN	`sebzevat`
seçal	POST-NOUN	`seçal`
sedef	POST-NOUN	`sedef`
sedefkar	POST-NOUN	`sedefkar`
sefahat	POST-NOUN	`sefahat`
sefirikebir	POST-NOUN	`sefirikebir`
segman	POST-NOUN	`segman`
sehim	POST-NOUN	`sehim`
sehiv	POST-NOUN	`sehiv`
sekans	POST-NOUN	`sekans`
sekbanbaþý	POST-NOUN	`sekbanbaþý`
sekel	POST-NOUN	`sekel`
sekil	POST-NOUN	`sekil`
sekiz	POST-NOUN	`sekiz`
sekizçifte	POST-NOUN	`sekizçifte`
sekiztek	POST-NOUN	`sekiztek`
seklem	POST-NOUN	`seklem`
seksen	POST-NOUN	`seksen`
seksolog	POST-NOUN	`seksolog`
seksoloji	POST-NOUN	`seksoloji`
sekstant	POST-NOUN	`sekstant`
sekteikalp	POST-NOUN	`sekteikalp`
sekülarist	POST-NOUN	`sekülarist`
sekülarizm	POST-NOUN	`sekülarizm`
selamünkavlen	POST-NOUN	`selamünkavlen`
selanik	POST-NOUN	`selanik`
selaset	POST-NOUN	`selaset`
selçuki	POST-NOUN	`selçuki`
seleksiyon	POST-NOUN	`seleksiyon`
selfdeterminasyon	POST-NOUN	`selfdeterminasyon`
selobant	POST-NOUN	`selobant`
selp	POST-NOUN	`selp`
selülit	POST-NOUN	`selülit`
selüloit	POST-NOUN	`selüloit`
selvi	POST-NOUN	`selvi`
selzede	POST-NOUN	`selzede`
sem	POST-NOUN	`sem`
sem	POST-NOUN	`sem`
semah	POST-NOUN	`semah`
semahat	POST-NOUN	`semahat`
semazen	POST-NOUN	`semazen`
semazenbaþý	POST-NOUN	`semazenbaþý`
sembol	POST-NOUN	`sembol`
semitik	POST-NOUN	`semitik`
semitizm	POST-NOUN	`semitizm`
semiyoloji	POST-NOUN	`semiyoloji`
semizotu	POST-NOUN	`semizotu`
semtürreis	POST-NOUN	`semtürreis`
sen	POST-NOUN	`sen`
seneidevriye	POST-NOUN	`seneidevriye`
seneikebise	POST-NOUN	`seneikebise`
senet	POST-NOUN	`senet`
senir	POST-NOUN	`senir`
senit	POST-NOUN	`senit`
senozoik	POST-NOUN	`senozoik`
sent	POST-NOUN	`sent`
sepetkulpu	POST-NOUN	`sepetkulpu`
serap	POST-NOUN	`serap`
serenat	POST-NOUN	`serenat`
serencam	POST-NOUN	`serencam`
serendi	POST-NOUN	`serendi`
seretan	POST-NOUN	`seretan`
seretan	POST-NOUN	`seretan`
sergievi	POST-NOUN	`sergievi`
serhat	POST-NOUN	`serhat`
serim	POST-NOUN	`serim`
sermesti	POST-NOUN	`sermesti`
sermürettip	POST-NOUN	`sermürettip`
sertabip	POST-NOUN	`sertabip`
sertap	POST-NOUN	`sertap`
sertifikasyon	POST-NOUN	`sertifikasyon`
seryaver	POST-NOUN	`seryaver`
sesletim	POST-NOUN	`sesletim`
sesyayar	POST-NOUN	`sesyayar`
seter	POST-NOUN	`seter`
setik	POST-NOUN	`setik`
setir	POST-NOUN	`setir`
setriavret	POST-NOUN	`setriavret`
sevap	POST-NOUN	`sevap`
sevdiceðim	POST-NOUN	`sevdiceðim`
sevim	POST-NOUN	`sevim`
sevir	POST-NOUN	`sevir`
sevk	POST-NOUN	`sevk`
sevkitabii	POST-NOUN	`sevkitabii`
sevkülceyþ	POST-NOUN	`sevkülceyþ`
seyahat	POST-NOUN	`seyahat`
seyfiye	POST-NOUN	`seyfiye`
seyir	POST-NOUN	`seyir`
seyit	POST-NOUN	`seyit`
seylani	POST-NOUN	`seylani`
seylap	POST-NOUN	`seylap`
seymen	POST-NOUN	`seymen`
seyyiat	POST-NOUN	`seyyiat`
seyyie	POST-NOUN	`seyyie`
sýcak	POST-NOUN	`sýcak`
sýcaklýkyayar	POST-NOUN	`sýcaklýkyayar`
sýçandiþi	POST-NOUN	`sýçandiþi`
sýçankulaðý	POST-NOUN	`sýçankulaðý`
sýçankuyruðu	POST-NOUN	`sýçankuyruðu`
sýçanotu	POST-NOUN	`sýçanotu`
sýdk	POST-NOUN	`sýdk`
sýðýrgözü	POST-NOUN	`sýðýrgözü`
sýðýrkuyruðu	POST-NOUN	`sýðýrkuyruðu`
sýðýrödü	POST-NOUN	`sýðýrödü`
sýðla	POST-NOUN	`sýðla`
sýhhat	POST-NOUN	`sýhhat`
sýkacak	POST-NOUN	`sýkacak`
sýlayýrahim	POST-NOUN	`sýlayýrahim`
sýnaat	POST-NOUN	`sýnaat`
sýnýflandýrmak	POST-NOUN	`sýnýflandýrmak`
sýrmakeþhane	POST-NOUN	`sýrmakeþhane`
sýrp	POST-NOUN	`sýrp`
sýyanet	POST-NOUN	`sýyanet`
sýygý	POST-NOUN	`sýygý`
sibakusiyak	POST-NOUN	`sibakusiyak`
sibernasyon	POST-NOUN	`sibernasyon`
siborgiyum	POST-NOUN	`siborgiyum`
sif	POST-NOUN	`sif`
sifin	POST-NOUN	`sifin`
sigala	POST-NOUN	`sigala`
sigar	POST-NOUN	`sigar`
sih	POST-NOUN	`sih`
sihir	POST-NOUN	`sihir`
sik	POST-NOUN	`sik`
silahaltý	POST-NOUN	`silahaltý`
silaj	POST-NOUN	`silaj`
silecek	POST-NOUN	`silecek`
silgeç	POST-NOUN	`silgeç`
silikon	POST-NOUN	`silikon`
silikoz	POST-NOUN	`silikoz`
silindir	POST-NOUN	`silindir`
silsileimeratip	POST-NOUN	`silsileimeratip`
silüet	POST-NOUN	`silüet`
simetri	POST-NOUN	`simetri`
simit	POST-NOUN	`simit`
simpozyum	POST-NOUN	`simpozyum`
simurg	POST-NOUN	`simurg`
sinagrit	POST-NOUN	`sinagrit`
sincap	POST-NOUN	`sincap`
sinekoloji	POST-NOUN	`sinekoloji`
sinekromi	POST-NOUN	`sinekromi`
sineksavar	POST-NOUN	`sineksavar`
sinematek	POST-NOUN	`sinematek`
sinematografi	POST-NOUN	`sinematografi`
sineroman	POST-NOUN	`sineroman`
sineyimillet	POST-NOUN	`sineyimillet`
single	POST-NOUN	`single`
sinizm	POST-NOUN	`sinizm`
sinle	POST-NOUN	`sinle`
sinolog	POST-NOUN	`sinolog`
sinoloji	POST-NOUN	`sinoloji`
sinsin	POST-NOUN	`sinsin`
sinüzoit	POST-NOUN	`sinüzoit`
sinyal	POST-NOUN	`sinyal`
sirk	POST-NOUN	`sirk`
sirkat	POST-NOUN	`sirkat`
sirken	POST-NOUN	`sirken`
sirmo	POST-NOUN	`sirmo`
sirtaki	POST-NOUN	`sirtaki`
sismolog	POST-NOUN	`sismolog`
sismoloji	POST-NOUN	`sismoloji`
sit	POST-NOUN	`sit`
sitoloji	POST-NOUN	`sitoloji`
sitteisevir	POST-NOUN	`sitteisevir`
sivriç	POST-NOUN	`sivriç`
siyah	POST-NOUN	`siyah`
siyakat	POST-NOUN	`siyakat`
siyakusibak	POST-NOUN	`siyakusibak`
siyanürik	POST-NOUN	`siyanürik`
siyer	POST-NOUN	`siyer`
siyonist	POST-NOUN	`siyonist`
siyonizm	POST-NOUN	`siyonizm`
skala	POST-NOUN	`skala`
skandinav	POST-NOUN	`skandinav`
skif	POST-NOUN	`skif`
skink	POST-NOUN	`skink`
skoç	POST-NOUN	`skoç`
skor	POST-NOUN	`skor`
skorbort	POST-NOUN	`skorbort`
slalom	POST-NOUN	`slalom`
slap	POST-NOUN	`slap`
slav	POST-NOUN	`slav`
slavist	POST-NOUN	`slavist`
slavistik	POST-NOUN	`slavistik`
slayt	POST-NOUN	`slayt`
slip	POST-NOUN	`slip`
slovak	POST-NOUN	`slovak`
sloven	POST-NOUN	`sloven`
smaç	POST-NOUN	`smaç`
smaçör	POST-NOUN	`smaçör`
snobizm	POST-NOUN	`snobizm`
sofiyan	POST-NOUN	`sofiyan`
sofora	POST-NOUN	`sofora`
soðuk	POST-NOUN	`soðuk`
soðumölçer	POST-NOUN	`soðumölçer`
sokum	POST-NOUN	`sokum`
sol	POST-NOUN	`sol`
sol	POST-NOUN	`sol`
sol	POST-NOUN	`sol`
solusyon	POST-NOUN	`solusyon`
somak	POST-NOUN	`somak`
somak	POST-NOUN	`somak`
somnambulizm	POST-NOUN	`somnambulizm`
somon	POST-NOUN	`somon`
sormuk	POST-NOUN	`sormuk`
sosyolog	POST-NOUN	`sosyolog`
sosyoloji	POST-NOUN	`sosyoloji`
sosyolojizm	POST-NOUN	`sosyolojizm`
sovhoz	POST-NOUN	`sovhoz`
sovyet	POST-NOUN	`sovyet`
soyadý	POST-NOUN	`soyadý`
söðe	POST-NOUN	`söðe`
söðüt	POST-NOUN	`söðüt`
söküm	POST-NOUN	`söküm`
sömestir	POST-NOUN	`sömestir`
sör	POST-NOUN	`sör`
sör	POST-NOUN	`sör`
sörf	POST-NOUN	`sörf`
söven	POST-NOUN	`söven`
sövüntü	POST-NOUN	`sövüntü`
spagetti	POST-NOUN	`spagetti`
spastik	POST-NOUN	`spastik`
spatula	POST-NOUN	`spatula`
sperm	POST-NOUN	`sperm`
spesiyalist	POST-NOUN	`spesiyalist`
spiral	POST-NOUN	`spiral`
sponsor	POST-NOUN	`sponsor`
sprint	POST-NOUN	`sprint`
sprinter	POST-NOUN	`sprinter`
stabilizasyon	POST-NOUN	`stabilizasyon`
stagflasyon	POST-NOUN	`stagflasyon`
stalaktit	POST-NOUN	`stalaktit`
standardizasyon	POST-NOUN	`standardizasyon`
standart	POST-NOUN	`standart`
stant	POST-NOUN	`stant`
start	POST-NOUN	`start`
stat	POST-NOUN	`stat`
stent	POST-NOUN	`stent`
steradyan	POST-NOUN	`steradyan`
stereotip	POST-NOUN	`stereotip`
sterol	POST-NOUN	`sterol`
stor	POST-NOUN	`stor`
stratej	POST-NOUN	`stratej`
streç	POST-NOUN	`streç`
streptokok	POST-NOUN	`streptokok`
strüktür	POST-NOUN	`strüktür`
su	POST-NOUN	`su`
su	POST-NOUN	`su`
sual	POST-NOUN	`sual`
subaþý	POST-NOUN	`subaþý`
subjektivist	POST-NOUN	`subjektivist`
subjektivite	POST-NOUN	`subjektivite`
subjektivizm	POST-NOUN	`subjektivizm`
subret	POST-NOUN	`subret`
suç	POST-NOUN	`suç`
suçiçeði	POST-NOUN	`suçiçeði`
suflöz	POST-NOUN	`suflöz`
suhunet	POST-NOUN	`suhunet`
suibriði	POST-NOUN	`suibriði`
suistimal	POST-NOUN	`suistimal`
sulantý	POST-NOUN	`sulantý`
sulp	POST-NOUN	`sulp`
sultanihüzzam	POST-NOUN	`sultanihüzzam`
sultaniyegah	POST-NOUN	`sultaniyegah`
sumsuk	POST-NOUN	`sumsuk`
sunta	POST-NOUN	`sunta`
sunum	POST-NOUN	`sunum`
suoku	POST-NOUN	`suoku`
supangle	POST-NOUN	`supangle`
supap	POST-NOUN	`supap`
supara	POST-NOUN	`supara`
suples	POST-NOUN	`suples`
sura	POST-NOUN	`sura`
suþeridi	POST-NOUN	`suþeridi`
suþi	POST-NOUN	`suþi`
sutaþý	POST-NOUN	`sutaþý`
suvare	POST-NOUN	`suvare`
suzeni	POST-NOUN	`suzeni`
sübap	POST-NOUN	`sübap`
sübvanse	POST-NOUN	`sübvanse`
sücut	POST-NOUN	`sücut`
süheyl	POST-NOUN	`süheyl`
süit	POST-NOUN	`süit`
sükün	POST-NOUN	`sükün`
sükünet	POST-NOUN	`sükünet`
süküt	POST-NOUN	`süküt`
sülfamit	POST-NOUN	`sülfamit`
sülfit	POST-NOUN	`sülfit`
sülfürimetre	POST-NOUN	`sülfürimetre`
sümbüle	POST-NOUN	`sümbüle`
sümbülteber	POST-NOUN	`sümbülteber`
sümer	POST-NOUN	`sümer`
sümerolog	POST-NOUN	`sümerolog`
sümeroloji	POST-NOUN	`sümeroloji`
sündüs	POST-NOUN	`sündüs`
sünger	POST-NOUN	`sünger`
sünni	POST-NOUN	`sünni`
sürat	POST-NOUN	`sürat`
sürç	POST-NOUN	`sürç`
sürçülisan	POST-NOUN	`sürçülisan`
sürdürüm	POST-NOUN	`sürdürüm`
süreölçen	POST-NOUN	`süreölçen`
süreyya	POST-NOUN	`süreyya`
sürfile	POST-NOUN	`sürfile`
sürmanþet	POST-NOUN	`sürmanþet`
sürnatüralist	POST-NOUN	`sürnatüralist`
sürnatüralizm	POST-NOUN	`sürnatüralizm`
sürre	POST-NOUN	`sürre`
sürrealite	POST-NOUN	`sürrealite`
sürsat	POST-NOUN	`sürsat`
sürur	POST-NOUN	`sürur`
sürveyan	POST-NOUN	`sürveyan`
süthane	POST-NOUN	`süthane`
sütkýz	POST-NOUN	`sütkýz`
sütoðul	POST-NOUN	`sütoðul`
sütre	POST-NOUN	`sütre`
sütuncuk	POST-NOUN	`sütuncuk`
sütyen	POST-NOUN	`sütyen`
süve	POST-NOUN	`süve`
süven	POST-NOUN	`süven`
süveyda	POST-NOUN	`süveyda`
süyek	POST-NOUN	`süyek`
þafii	POST-NOUN	`þafii`
þahap	POST-NOUN	`þahap`
þahým	POST-NOUN	`þahým`
þahýs	POST-NOUN	`þahýs`
þahit	POST-NOUN	`þahit`
þahmeran	POST-NOUN	`þahmeran`
þahne	POST-NOUN	`þahne`
þahniþin	POST-NOUN	`þahniþin`
þahtur	POST-NOUN	`þahtur`
þaire	POST-NOUN	`þaire`
þak	POST-NOUN	`þak`
þak	POST-NOUN	`þak`
þakýldak	POST-NOUN	`þakýldak`
þakirt	POST-NOUN	`þakirt`
þakul	POST-NOUN	`þakul`
þalaki	POST-NOUN	`þalaki`
þale	POST-NOUN	`þale`
þallak	POST-NOUN	`þallak`
þalupa	POST-NOUN	`þalupa`
þaman	POST-NOUN	`þaman`
þamani	POST-NOUN	`þamani`
þamanist	POST-NOUN	`þamanist`
þamanizm	POST-NOUN	`þamanizm`
þambabasý	POST-NOUN	`þambabasý`
þambrel	POST-NOUN	`þambrel`
þandel	POST-NOUN	`þandel`
þanson	POST-NOUN	`þanson`
þansonet	POST-NOUN	`þansonet`
þantung	POST-NOUN	`þantung`
þaphane	POST-NOUN	`þaphane`
þapirograf	POST-NOUN	`þapirograf`
þarampol	POST-NOUN	`þarampol`
þarap	POST-NOUN	`þarap`
þark	POST-NOUN	`þark`
þark	POST-NOUN	`þark`
þarlatan	POST-NOUN	`þarlatan`
þarpi	POST-NOUN	`þarpi`
þase	POST-NOUN	`þase`
þat	POST-NOUN	`þat`
þataf	POST-NOUN	`þataf`
þathiyat	POST-NOUN	`þathiyat`
þathiye	POST-NOUN	`þathiye`
þavk	POST-NOUN	`þavk`
þavul	POST-NOUN	`þavul`
þe	POST-NOUN	`þe`
þeb	POST-NOUN	`þeb`
þebabet	POST-NOUN	`þebabet`
þebiarus	POST-NOUN	`þebiarus`
þebiarus	POST-NOUN	`þebiarus`
þebiyelda	POST-NOUN	`þebiyelda`
þecaat	POST-NOUN	`þecaat`
þedaraban	POST-NOUN	`þedaraban`
þefaat	POST-NOUN	`þefaat`
þefkat	POST-NOUN	`þefkat`
þeh	POST-NOUN	`þeh`
þehadet	POST-NOUN	`þehadet`
þehir	POST-NOUN	`þehir`
þehit	POST-NOUN	`þehit`
þehremaneti	POST-NOUN	`þehremaneti`
þehremini	POST-NOUN	`þehremini`
þehriyar	POST-NOUN	`þehriyar`
þehvaniyet	POST-NOUN	`þehvaniyet`
þek	POST-NOUN	`þek`
þekavet	POST-NOUN	`þekavet`
þekel	POST-NOUN	`þekel`
þekerciboyasý	POST-NOUN	`þekerciboyasý`
þekil	POST-NOUN	`þekil`
þekilperest	POST-NOUN	`þekilperest`
þelek	POST-NOUN	`þelek`
þem	POST-NOUN	`þem`
þems	POST-NOUN	`þems`
þenaat	POST-NOUN	`þenaat`
þeniyet	POST-NOUN	`þeniyet`
þepit	POST-NOUN	`þepit`
þerç	POST-NOUN	`þerç`
þerit	POST-NOUN	`þerit`
þeþüdü	POST-NOUN	`þeþüdü`
þet	POST-NOUN	`þet`
þetaret	POST-NOUN	`þetaret`
þetim	POST-NOUN	`þetim`
þetlant	POST-NOUN	`þetlant`
þevahit	POST-NOUN	`þevahit`
þevk	POST-NOUN	`þevk`
þevkefza	POST-NOUN	`þevkefza`
þevket	POST-NOUN	`þevket`
þevval	POST-NOUN	`þevval`
þeytanarabasý	POST-NOUN	`þeytanarabasý`
þeytanfeneri	POST-NOUN	`þeytanfeneri`
þeytanýlain	POST-NOUN	`þeytanýlain`
þýk	POST-NOUN	`þýk`
þýkþýk	POST-NOUN	`þýkþýk`
þýngýl	POST-NOUN	`þýngýl`
þýpýrtý	POST-NOUN	`þýpýrtý`
þýraölçer	POST-NOUN	`þýraölçer`
þia	POST-NOUN	`þia`
þifahane	POST-NOUN	`þifahane`
þifon	POST-NOUN	`þifon`
þifonyer	POST-NOUN	`þifonyer`
þii	POST-NOUN	`þii`
þiiriyet	POST-NOUN	`þiiriyet`
þikar	POST-NOUN	`þikar`
þilem	POST-NOUN	`þilem`
þilep	POST-NOUN	`þilep`
þilt	POST-NOUN	`þilt`
þimal	POST-NOUN	`þimal`
þimþir	POST-NOUN	`þimþir`
þinto	POST-NOUN	`þinto`
þintoizm	POST-NOUN	`þintoizm`
þip	POST-NOUN	`þip`
þirk	POST-NOUN	`þirk`
þita	POST-NOUN	`þita`
þitaiye	POST-NOUN	`þitaiye`
þizofren	POST-NOUN	`þizofren`
þlempe	POST-NOUN	`þlempe`
þnitzel	POST-NOUN	`þnitzel`
þnorkel	POST-NOUN	`þnorkel`
þok	POST-NOUN	`þok`
þolo	POST-NOUN	`þolo`
þopar	POST-NOUN	`þopar`
þor	POST-NOUN	`þor`
þorolo	POST-NOUN	`þorolo`
þovmen	POST-NOUN	`þovmen`
þovrum	POST-NOUN	`þovrum`
þöbiyet	POST-NOUN	`þöbiyet`
þömiz	POST-NOUN	`þömiz`
þömüz	POST-NOUN	`þömüz`
þuara	POST-NOUN	`þuara`
þüra	POST-NOUN	`þüra`
þurup	POST-NOUN	`þurup`
þuuraltý	POST-NOUN	`þuuraltý`
þükür	POST-NOUN	`þükür`
þümul	POST-NOUN	`þümul`
þvester	POST-NOUN	`þvester`
taaccüp	POST-NOUN	`taaccüp`
taaddüt	POST-NOUN	`taaddüt`
taahhüt	POST-NOUN	`taahhüt`
taam	POST-NOUN	`taam`
taammüt	POST-NOUN	`taammüt`
taannüt	POST-NOUN	`taannüt`
taassup	POST-NOUN	`taassup`
taaþþuk	POST-NOUN	`taaþþuk`
taat	POST-NOUN	`taat`
taayyün	POST-NOUN	`taayyün`
tab	POST-NOUN	`tab`
tab	POST-NOUN	`tab`
taba	POST-NOUN	`taba`
tabaat	POST-NOUN	`tabaat`
tabildot	POST-NOUN	`tabildot`
tabip	POST-NOUN	`tabip`
tabl	POST-NOUN	`tabl`
tabliye	POST-NOUN	`tabliye`
tabütüvan	POST-NOUN	`tabütüvan`
tadat	POST-NOUN	`tadat`
tafta	POST-NOUN	`tafta`
tagallüp	POST-NOUN	`tagallüp`
tagayyür	POST-NOUN	`tagayyür`
taðyir	POST-NOUN	`taðyir`
tahaccüm	POST-NOUN	`tahaccüm`
tahaccür	POST-NOUN	`tahaccür`
tahaffuz	POST-NOUN	`tahaffuz`
tahaffuzhane	POST-NOUN	`tahaffuzhane`
tahammuz	POST-NOUN	`tahammuz`
tahassun	POST-NOUN	`tahassun`
tahassüs	POST-NOUN	`tahassüs`
tahaþþüt	POST-NOUN	`tahaþþüt`
tahattur	POST-NOUN	`tahattur`
tahdidat	POST-NOUN	`tahdidat`
tahdit	POST-NOUN	`tahdit`
tahlif	POST-NOUN	`tahlif`
tahlis	POST-NOUN	`tahlis`
tahril	POST-NOUN	`tahril`
tahrip	POST-NOUN	`tahrip`
tahsisatýmesture	POST-NOUN	`tahsisatýmesture`
tahþiye	POST-NOUN	`tahþiye`
tahta	POST-NOUN	`tahta`
tahtakurularý	POST-NOUN	`tahtakurularý`
tahtakurusu	POST-NOUN	`tahtakurusu`
tahtalýköy	POST-NOUN	`tahtalýköy`
tahtelbahir	POST-NOUN	`tahtelbahir`
tahteþþuur	POST-NOUN	`tahteþþuur`
tak	POST-NOUN	`tak`
tak	POST-NOUN	`tak`
takarrüp	POST-NOUN	`takarrüp`
takayyüt	POST-NOUN	`takayyüt`
takdiriilahi	POST-NOUN	`takdiriilahi`
takeometre	POST-NOUN	`takeometre`
takigraf	POST-NOUN	`takigraf`
takim	POST-NOUN	`takim`
takimetre	POST-NOUN	`takimetre`
takip	POST-NOUN	`takip`
takiye	POST-NOUN	`takiye`
taklit	POST-NOUN	`taklit`
takograf	POST-NOUN	`takograf`
takometre	POST-NOUN	`takometre`
takrip	POST-NOUN	`takrip`
takriz	POST-NOUN	`takriz`
taksimetre	POST-NOUN	`taksimetre`
taksit	POST-NOUN	`taksit`
taksonomi	POST-NOUN	`taksonomi`
takt	POST-NOUN	`takt`
takti	POST-NOUN	`takti`
takyit	POST-NOUN	`takyit`
tal	POST-NOUN	`tal`
talakýselase	POST-NOUN	`talakýselase`
talep	POST-NOUN	`talep`
talil	POST-NOUN	`talil`
talimar	POST-NOUN	`talimar`
talip	POST-NOUN	`talip`
talk	POST-NOUN	`talk`
tallahi	POST-NOUN	`tallahi`
tamamiyet	POST-NOUN	`tamamiyet`
tamanit	POST-NOUN	`tamanit`
tamik	POST-NOUN	`tamik`
tamzara	POST-NOUN	`tamzara`
tanassur	POST-NOUN	`tanassur`
tandem	POST-NOUN	`tandem`
tangýrtý	POST-NOUN	`tangýrtý`
tanin	POST-NOUN	`tanin`
tank	POST-NOUN	`tank`
tanrý	POST-NOUN	`tanrý`
tanrý	POST-NOUN	`tanrý`
tansiyometre	POST-NOUN	`tansiyometre`
tansiyometri	POST-NOUN	`tansiyometri`
tantuni	POST-NOUN	`tantuni`
tanzimat	POST-NOUN	`tanzimat`
tanzimat	POST-NOUN	`tanzimat`
tanzir	POST-NOUN	`tanzir`
taoizm	POST-NOUN	`taoizm`
tapýrtý	POST-NOUN	`tapýrtý`
tapi	POST-NOUN	`tapi`
tar	POST-NOUN	`tar`
taraba	POST-NOUN	`taraba`
taraþ	POST-NOUN	`taraþ`
tarçýni	POST-NOUN	`tarçýni`
tardiye	POST-NOUN	`tardiye`
tarýk	POST-NOUN	`tarýk`
tarlatan	POST-NOUN	`tarlatan`
tarsin	POST-NOUN	`tarsin`
tartar	POST-NOUN	`tartar`
tartarat	POST-NOUN	`tartarat`
tartým	POST-NOUN	`tartým`
tasallut	POST-NOUN	`tasallut`
tasallüp	POST-NOUN	`tasallüp`
tasannu	POST-NOUN	`tasannu`
tasdi	POST-NOUN	`tasdi`
tasdik	POST-NOUN	`tasdik`
tasgir	POST-NOUN	`tasgir`
tashihikarar	POST-NOUN	`tashihikarar`
tasmim	POST-NOUN	`tasmim`
tasni	POST-NOUN	`tasni`
tastir	POST-NOUN	`tastir`
tasvip	POST-NOUN	`tasvip`
taþ	POST-NOUN	`taþ`
taþak	POST-NOUN	`taþak`
taþemen	POST-NOUN	`taþemen`
taþýnabilir	POST-NOUN	`taþýnabilir`
taþýnýr	POST-NOUN	`taþýnýr`
taþýntý	POST-NOUN	`taþýntý`
taþikardi	POST-NOUN	`taþikardi`
taþizm	POST-NOUN	`taþizm`
taþkýran	POST-NOUN	`taþkýran`
tat	POST-NOUN	`tat`
tat	POST-NOUN	`tat`
tat	POST-NOUN	`tat`
tavattun	POST-NOUN	`tavattun`
tavhane	POST-NOUN	`tavhane`
tavýr	POST-NOUN	`tavýr`
tavik	POST-NOUN	`tavik`
tavþanaðzý	POST-NOUN	`tavþanaðzý`
tavþanayaðý	POST-NOUN	`tavþanayaðý`
tavþanbýyýðý	POST-NOUN	`tavþanbýyýðý`
tavþankaný	POST-NOUN	`tavþankaný`
tavþankulaðý	POST-NOUN	`tavþankulaðý`
tavukayaðý	POST-NOUN	`tavukayaðý`
tavukgötü	POST-NOUN	`tavukgötü`
tavukkarasý	POST-NOUN	`tavukkarasý`
tavuskuyruðu	POST-NOUN	`tavuskuyruðu`
tayga	POST-NOUN	`tayga`
tayip	POST-NOUN	`tayip`
tayt	POST-NOUN	`tayt`
tazammun	POST-NOUN	`tazammun`
tazarru	POST-NOUN	`tazarru`
taze	POST-NOUN	`taze`
tazimat	POST-NOUN	`tazimat`
tazip	POST-NOUN	`tazip`
taziyet	POST-NOUN	`taziyet`
te	POST-NOUN	`te`
teadül	POST-NOUN	`teadül`
teakup	POST-NOUN	`teakup`
tearuz	POST-NOUN	`tearuz`
teavün	POST-NOUN	`teavün`
tebaiyet	POST-NOUN	`tebaiyet`
tebdilimekan	POST-NOUN	`tebdilimekan`
tebeddülat	POST-NOUN	`tebeddülat`
teberrük	POST-NOUN	`teberrük`
teberrüz	POST-NOUN	`teberrüz`
tebriye	POST-NOUN	`tebriye`
tebþir	POST-NOUN	`tebþir`
tebyiz	POST-NOUN	`tebyiz`
tecahülüarif	POST-NOUN	`tecahülüarif`
tecahülüarifane	POST-NOUN	`tecahülüarifane`
tecanüs	POST-NOUN	`tecanüs`
tecdit	POST-NOUN	`tecdit`
teceddüt	POST-NOUN	`teceddüt`
tecemmu	POST-NOUN	`tecemmu`
tecerrüt	POST-NOUN	`tecerrüt`
tecimen	POST-NOUN	`tecimen`
tecimevi	POST-NOUN	`tecimevi`
tecrit	POST-NOUN	`tecrit`
tecrübi	POST-NOUN	`tecrübi`
tecvit	POST-NOUN	`tecvit`
teçhil	POST-NOUN	`teçhil`
tedfin	POST-NOUN	`tedfin`
tedip	POST-NOUN	`tedip`
tedriç	POST-NOUN	`tedriç`
teeddüp	POST-NOUN	`teeddüp`
teehhül	POST-NOUN	`teehhül`
teehhür	POST-NOUN	`teehhür`
teessürat	POST-NOUN	`teessürat`
teeyyüt	POST-NOUN	`teeyyüt`
tefahhus	POST-NOUN	`tefahhus`
tefarik	POST-NOUN	`tefarik`
tefavüt	POST-NOUN	`tefavüt`
tefcir	POST-NOUN	`tefcir`
teferrüç	POST-NOUN	`teferrüç`
teferrüt	POST-NOUN	`teferrüt`
tefeül	POST-NOUN	`tefeül`
tefevvuk	POST-NOUN	`tefevvuk`
tefeyyüz	POST-NOUN	`tefeyyüz`
teflon	POST-NOUN	`teflon`
tefriþat	POST-NOUN	`tefriþat`
teftih	POST-NOUN	`teftih`
tefviz	POST-NOUN	`tefviz`
teganni	POST-NOUN	`teganni`
tehalüf	POST-NOUN	`tehalüf`
tehdit	POST-NOUN	`tehdit`
teheyyüç	POST-NOUN	`teheyyüç`
tehiriicra	POST-NOUN	`tehiriicra`
tehyiç	POST-NOUN	`tehyiç`
tehzil	POST-NOUN	`tehzil`
tek	POST-NOUN	`tek`
tekalif	POST-NOUN	`tekalif`
tekapu	POST-NOUN	`tekapu`
tekasül	POST-NOUN	`tekasül`
tekaüt	POST-NOUN	`tekaüt`
tekellüf	POST-NOUN	`tekellüf`
tekessür	POST-NOUN	`tekessür`
tekfir	POST-NOUN	`tekfir`
tekila	POST-NOUN	`tekila`
tekit	POST-NOUN	`tekit`
teknoloji	POST-NOUN	`teknoloji`
tekst	POST-NOUN	`tekst`
tekzip	POST-NOUN	`tekzip`
telaki	POST-NOUN	`telaki`
telaþe	POST-NOUN	`telaþe`
telatin	POST-NOUN	`telatin`
telefonometre	POST-NOUN	`telefonometre`
telekart	POST-NOUN	`telekart`
telekýz	POST-NOUN	`telekýz`
telekonferans	POST-NOUN	`telekonferans`
telem	POST-NOUN	`telem`
telemetre	POST-NOUN	`telemetre`
telemetri	POST-NOUN	`telemetri`
teleoloji	POST-NOUN	`teleoloji`
teleradar	POST-NOUN	`teleradar`
telesekreter	POST-NOUN	`telesekreter`
telesine	POST-NOUN	`telesine`
telesiyej	POST-NOUN	`telesiyej`
teleskobik	POST-NOUN	`teleskobik`
teleüt	POST-NOUN	`teleüt`
telfin	POST-NOUN	`telfin`
telhis	POST-NOUN	`telhis`
telvis	POST-NOUN	`telvis`
telyazý	POST-NOUN	`telyazý`
telyazýsý	POST-NOUN	`telyazýsý`
tem	POST-NOUN	`tem`
temaruz	POST-NOUN	`temaruz`
tembihat	POST-NOUN	`tembihat`
tembul	POST-NOUN	`tembul`
temcit	POST-NOUN	`temcit`
temdit	POST-NOUN	`temdit`
temeddüh	POST-NOUN	`temeddüh`
temeddün	POST-NOUN	`temeddün`
temel	POST-NOUN	`temel`
temerrüt	POST-NOUN	`temerrüt`
temessül	POST-NOUN	`temessül`
temevvüç	POST-NOUN	`temevvüç`
temhir	POST-NOUN	`temhir`
tenafür	POST-NOUN	`tenafür`
tenasüh	POST-NOUN	`tenasüh`
tenasüp	POST-NOUN	`tenasüp`
teneffüshane	POST-NOUN	`teneffüshane`
tenge	POST-NOUN	`tenge`
tenkis	POST-NOUN	`tenkis`
tenkiye	POST-NOUN	`tenkiye`
tensik	POST-NOUN	`tensik`
tensil	POST-NOUN	`tensil`
tensip	POST-NOUN	`tensip`
tentürdiyot	POST-NOUN	`tentürdiyot`
tenzilirütbe	POST-NOUN	`tenzilirütbe`
teogoni	POST-NOUN	`teogoni`
teokrat	POST-NOUN	`teokrat`
teolog	POST-NOUN	`teolog`
teoloji	POST-NOUN	`teoloji`
tepebaþý	POST-NOUN	`tepebaþý`
tephir	POST-NOUN	`tephir`
tepi	POST-NOUN	`tepi`
tepik	POST-NOUN	`tepik`
teraküm	POST-NOUN	`teraküm`
terasa	POST-NOUN	`terasa`
teravih	POST-NOUN	`teravih`
terbi	POST-NOUN	`terbi`
tercihane	POST-NOUN	`tercihane`
terciibent	POST-NOUN	`terciibent`
tercümeihal	POST-NOUN	`tercümeihal`
terdit	POST-NOUN	`terdit`
tereddüt	POST-NOUN	`tereddüt`
terek	POST-NOUN	`terek`
terekküp	POST-NOUN	`terekküp`
teressüp	POST-NOUN	`teressüp`
terettüp	POST-NOUN	`terettüp`
tereyaðý	POST-NOUN	`tereyaðý`
terfik	POST-NOUN	`terfik`
terk	POST-NOUN	`terk`
terkibibent	POST-NOUN	`terkibibent`
terkip	POST-NOUN	`terkip`
terkiphane	POST-NOUN	`terkiphane`
termin	POST-NOUN	`termin`
terminal	POST-NOUN	`terminal`
terminoloji	POST-NOUN	`terminoloji`
termiye	POST-NOUN	`termiye`
termodinamik	POST-NOUN	`termodinamik`
termoelektrik	POST-NOUN	`termoelektrik`
termofor	POST-NOUN	`termofor`
termograf	POST-NOUN	`termograf`
termokimya	POST-NOUN	`termokimya`
termometre	POST-NOUN	`termometre`
termostat	POST-NOUN	`termostat`
tersbeþik	POST-NOUN	`tersbeþik`
tertip	POST-NOUN	`tertip`
tesahup	POST-NOUN	`tesahup`
tesalüp	POST-NOUN	`tesalüp`
tesanüt	POST-NOUN	`tesanüt`
tesdis	POST-NOUN	`tesdis`
teseyyüp	POST-NOUN	`teseyyüp`
teshil	POST-NOUN	`teshil`
tesit	POST-NOUN	`tesit`
testis	POST-NOUN	`testis`
tesvit	POST-NOUN	`tesvit`
tesviyeruhu	POST-NOUN	`tesviyeruhu`
teþdit	POST-NOUN	`teþdit`
teþehhüt	POST-NOUN	`teþehhüt`
teþrikimesai	POST-NOUN	`teþrikimesai`
teþrinievvel	POST-NOUN	`teþrinievvel`
teþrinisani	POST-NOUN	`teþrinisani`
teþt	POST-NOUN	`teþt`
teþvikkar	POST-NOUN	`teþvikkar`
tetkikat	POST-NOUN	`tetkikat`
tevafuk	POST-NOUN	`tevafuk`
tevakki	POST-NOUN	`tevakki`
tevazün	POST-NOUN	`tevazün`
tevbih	POST-NOUN	`tevbih`
tevellüt	POST-NOUN	`tevellüt`
tevettür	POST-NOUN	`tevettür`
tevfik	POST-NOUN	`tevfik`
tevhit	POST-NOUN	`tevhit`
tevki	POST-NOUN	`tevki`
tevkifat	POST-NOUN	`tevkifat`
tevlit	POST-NOUN	`tevlit`
tevliyet	POST-NOUN	`tevliyet`
tevrat	POST-NOUN	`tevrat`
tevþih	POST-NOUN	`tevþih`
teyit	POST-NOUN	`teyit`
teyp	POST-NOUN	`teyp`
tezat	POST-NOUN	`tezat`
tezayüt	POST-NOUN	`tezayüt`
tezellül	POST-NOUN	`tezellül`
tezelzül	POST-NOUN	`tezelzül`
tezevvüç	POST-NOUN	`tezevvüç`
tezhip	POST-NOUN	`tezhip`
tezvirat	POST-NOUN	`tezvirat`
tezyit	POST-NOUN	`tezyit`
týk	POST-NOUN	`týk`
týkým	POST-NOUN	`týkým`
týp	POST-NOUN	`týp`
týpkýsý	POST-NOUN	`týpkýsý`
týrýnk	POST-NOUN	`týrýnk`
týrývýrý	POST-NOUN	`týrývýrý`
tiabendazol	POST-NOUN	`tiabendazol`
ticani	POST-NOUN	`ticani`
ticani	POST-NOUN	`ticani`
ticaretgah	POST-NOUN	`ticaretgah`
tið	POST-NOUN	`tið`
tik	POST-NOUN	`tik`
tilkikuyruðu	POST-NOUN	`tilkikuyruðu`
timbal	POST-NOUN	`timbal`
timing	POST-NOUN	`timing`
timsal	POST-NOUN	`timsal`
tipo	POST-NOUN	`tipo`
tipografi	POST-NOUN	`tipografi`
tipoloji	POST-NOUN	`tipoloji`
tirat	POST-NOUN	`tirat`
tirhandil	POST-NOUN	`tirhandil`
tirhos	POST-NOUN	`tirhos`
tirit	POST-NOUN	`tirit`
tirle	POST-NOUN	`tirle`
tirlin	POST-NOUN	`tirlin`
tiroit	POST-NOUN	`tiroit`
titr	POST-NOUN	`titr`
toht	POST-NOUN	`toht`
tokat	POST-NOUN	`tokat`
tokat	POST-NOUN	`tokat`
toksikolog	POST-NOUN	`toksikolog`
toksikoloji	POST-NOUN	`toksikoloji`
toksikomani	POST-NOUN	`toksikomani`
tokurcun	POST-NOUN	`tokurcun`
tokyo	POST-NOUN	`tokyo`
tol	POST-NOUN	`tol`
tolkþov	POST-NOUN	`tolkþov`
tomahavk	POST-NOUN	`tomahavk`
tombik	POST-NOUN	`tombik`
tombilya	POST-NOUN	`tombilya`
toner	POST-NOUN	`toner`
tonmayster	POST-NOUN	`tonmayster`
tonoz	POST-NOUN	`tonoz`
toparlak	POST-NOUN	`toparlak`
topbaþ	POST-NOUN	`topbaþ`
topik	POST-NOUN	`topik`
toplanan	POST-NOUN	`toplanan`
topoðraf	POST-NOUN	`topoðraf`
topoðrafya	POST-NOUN	`topoðrafya`
topoloji	POST-NOUN	`topoloji`
toponimi	POST-NOUN	`toponimi`
toprakçýl	POST-NOUN	`toprakçýl`
topukdöven	POST-NOUN	`topukdöven`
torero	POST-NOUN	`torero`
torum	POST-NOUN	`torum`
total	POST-NOUN	`total`
totalitarizm	POST-NOUN	`totalitarizm`
toyga	POST-NOUN	`toyga`
tozan	POST-NOUN	`tozan`
tör	POST-NOUN	`tör`
tradisyon	POST-NOUN	`tradisyon`
tradisyonel	POST-NOUN	`tradisyonel`
tragedya	POST-NOUN	`tragedya`
trajikomedi	POST-NOUN	`trajikomedi`
trake	POST-NOUN	`trake`
trakeit	POST-NOUN	`trakeit`
traksiyon	POST-NOUN	`traksiyon`
trans	POST-NOUN	`trans`
transfüzyon	POST-NOUN	`transfüzyon`
transistör	POST-NOUN	`transistör`
transkripsiyon	POST-NOUN	`transkripsiyon`
transporter	POST-NOUN	`transporter`
trap	POST-NOUN	`trap`
tras	POST-NOUN	`tras`
trata	POST-NOUN	`trata`
traverten	POST-NOUN	`traverten`
travesti	POST-NOUN	`travesti`
travmatoloji	POST-NOUN	`travmatoloji`
trend	POST-NOUN	`trend`
tretuvar	POST-NOUN	`tretuvar`
trias	POST-NOUN	`trias`
triatlon	POST-NOUN	`triatlon`
triftong	POST-NOUN	`triftong`
trigonometri	POST-NOUN	`trigonometri`
trikosefal	POST-NOUN	`trikosefal`
triloji	POST-NOUN	`triloji`
trilyon	POST-NOUN	`trilyon`
trilyoner	POST-NOUN	`trilyoner`
triyas	POST-NOUN	`triyas`
trok	POST-NOUN	`trok`
trol	POST-NOUN	`trol`
tropik	POST-NOUN	`tropik`
tropikal	POST-NOUN	`tropikal`
trotinet	POST-NOUN	`trotinet`
truakar	POST-NOUN	`truakar`
trük	POST-NOUN	`trük`
tuba	POST-NOUN	`tuba`
tuba	POST-NOUN	`tuba`
tuðamiral	POST-NOUN	`tuðamiral`
tuðgeneral	POST-NOUN	`tuðgeneral`
tuðla	POST-NOUN	`tuðla`
tuðrik	POST-NOUN	`tuðrik`
tuðrul	POST-NOUN	`tuðrul`
tul	POST-NOUN	`tul`
tulup	POST-NOUN	`tulup`
tun	POST-NOUN	`tun`
tunç	POST-NOUN	`tunç`
tunik	POST-NOUN	`tunik`
tunus	POST-NOUN	`tunus`
turan	POST-NOUN	`turan`
turgay	POST-NOUN	`turgay`
turnaayaðý	POST-NOUN	`turnaayaðý`
turnagagasý	POST-NOUN	`turnagagasý`
turnageçidi	POST-NOUN	`turnageçidi`
turnagözü	POST-NOUN	`turnagözü`
turnusol	POST-NOUN	`turnusol`
tuþe	POST-NOUN	`tuþe`
tutacak	POST-NOUN	`tutacak`
tutturgaç	POST-NOUN	`tutturgaç`
tutukevi	POST-NOUN	`tutukevi`
tuval	POST-NOUN	`tuval`
tuyuð	POST-NOUN	`tuyuð`
tül	POST-NOUN	`tül`
tülbent	POST-NOUN	`tülbent`
tümamiral	POST-NOUN	`tümamiral`
tümgeneral	POST-NOUN	`tümgeneral`
tümür	POST-NOUN	`tümür`
türap	POST-NOUN	`türap`
türbülans	POST-NOUN	`türbülans`
türk	POST-NOUN	`türk`
türkiyat	POST-NOUN	`türkiyat`
türkkýymasý	POST-NOUN	`türkkýymasý`
türkkupasý	POST-NOUN	`türkkupasý`
türkmen	POST-NOUN	`türkmen`
türkolog	POST-NOUN	`türkolog`
türkoloji	POST-NOUN	`türkoloji`
tüvit	POST-NOUN	`tüvit`
tüy	POST-NOUN	`tüy`
tüyo	POST-NOUN	`tüyo`
tvist	POST-NOUN	`tvist`
uçmak	POST-NOUN	`uçmak`
uçun	POST-NOUN	`uçun`
ufuk	POST-NOUN	`ufuk`
uful	POST-NOUN	`uful`
uðut	POST-NOUN	`uðut`
uhuvvet	POST-NOUN	`uhuvvet`
uknum	POST-NOUN	`uknum`
ulah	POST-NOUN	`ulah`
ulantý	POST-NOUN	`ulantý`
ultramodern	POST-NOUN	`ultramodern`
ultrason	POST-NOUN	`ultrason`
ultraviyole	POST-NOUN	`ultraviyole`
uluhiyet	POST-NOUN	`uluhiyet`
umran	POST-NOUN	`umran`
umre	POST-NOUN	`umre`
umut	POST-NOUN	`umut`
uranüs	POST-NOUN	`uranüs`
urban	POST-NOUN	`urban`
urbanizm	POST-NOUN	`urbanizm`
urodel	POST-NOUN	`urodel`
urup	POST-NOUN	`urup`
usantý	POST-NOUN	`usantý`
ushuru	POST-NOUN	`ushuru`
ustabaþý	POST-NOUN	`ustabaþý`
usturlap	POST-NOUN	`usturlap`
usul	POST-NOUN	`usul`
usul	POST-NOUN	`usul`
ut	POST-NOUN	`ut`
ut	POST-NOUN	`ut`
uygulayým	POST-NOUN	`uygulayým`
uygur	POST-NOUN	`uygur`
uzak	POST-NOUN	`uzak`
uzlaþý	POST-NOUN	`uzlaþý`
uzlaþým	POST-NOUN	`uzlaþým`
uzo	POST-NOUN	`uzo`
uzuv	POST-NOUN	`uzuv`
üç	POST-NOUN	`üç`
üçayak	POST-NOUN	`üçayak`
üçbudak	POST-NOUN	`üçbudak`
üççatal	POST-NOUN	`üççatal`
üççeyrek	POST-NOUN	`üççeyrek`
üçgen	POST-NOUN	`üçgen`
üçkaðýt	POST-NOUN	`üçkaðýt`
üçkardeþ	POST-NOUN	`üçkardeþ`
üçtaþ	POST-NOUN	`üçtaþ`
üdeba	POST-NOUN	`üdeba`
ülen	POST-NOUN	`ülen`
ülker	POST-NOUN	`ülker`
ülküdaþ	POST-NOUN	`ülküdaþ`
ümit	POST-NOUN	`ümit`
ümük	POST-NOUN	`ümük`
üniversalizm	POST-NOUN	`üniversalizm`
üretimevi	POST-NOUN	`üretimevi`
ürokültür	POST-NOUN	`ürokültür`
ürolog	POST-NOUN	`ürolog`
üroloji	POST-NOUN	`üroloji`
ürtiker	POST-NOUN	`ürtiker`
üsalize	POST-NOUN	`üsalize`
üsçene	POST-NOUN	`üsçene`
üsderi	POST-NOUN	`üsderi`
üsdudak	POST-NOUN	`üsdudak`
üsera	POST-NOUN	`üsera`
üsküre	POST-NOUN	`üsküre`
üslup	POST-NOUN	`üslup`
üssubay	POST-NOUN	`üssubay`
üst	POST-NOUN	`üst`
üstat	POST-NOUN	`üstat`
üstün	POST-NOUN	`üstün`
üþenç	POST-NOUN	`üþenç`
üþüntü	POST-NOUN	`üþüntü`
üzenti	POST-NOUN	`üzenti`
üzeri	POST-NOUN	`üzeri`
üzümgüneþi	POST-NOUN	`üzümgüneþi`
vaat	POST-NOUN	`vaat`
vaftizhane	POST-NOUN	`vaftizhane`
vagotoni	POST-NOUN	`vagotoni`
vahdaniyet	POST-NOUN	`vahdaniyet`
vahdetivücut	POST-NOUN	`vahdetivücut`
vahiy	POST-NOUN	`vahiy`
vajina	POST-NOUN	`vajina`
vakýf	POST-NOUN	`vakýf`
vakit	POST-NOUN	`vakit`
vaks	POST-NOUN	`vaks`
vaktikerahet	POST-NOUN	`vaktikerahet`
vakvak	POST-NOUN	`vakvak`
valör	POST-NOUN	`valör`
vamp	POST-NOUN	`vamp`
vapurdumaný	POST-NOUN	`vapurdumaný`
varakpare	POST-NOUN	`varakpare`
vardabandýra	POST-NOUN	`vardabandýra`
vardela	POST-NOUN	`vardela`
varide	POST-NOUN	`varide`
varsaðý	POST-NOUN	`varsaðý`
varyos	POST-NOUN	`varyos`
vasektomi	POST-NOUN	`vasektomi`
vasýf	POST-NOUN	`vasýf`
vatvat	POST-NOUN	`vatvat`
vaz	POST-NOUN	`vaz`
vazýhamil	POST-NOUN	`vazýhamil`
vebal	POST-NOUN	`vebal`
vecih	POST-NOUN	`vecih`
vect	POST-NOUN	`vect`
veçhiþebeh	POST-NOUN	`veçhiþebeh`
vehim	POST-NOUN	`vehim`
vejetalizm	POST-NOUN	`vejetalizm`
vejetarizm	POST-NOUN	`vejetarizm`
vejetaryen	POST-NOUN	`vejetaryen`
vejetasyon	POST-NOUN	`vejetasyon`
veksilloji	POST-NOUN	`veksilloji`
veledizina	POST-NOUN	`veledizina`
velespit	POST-NOUN	`velespit`
velet	POST-NOUN	`velet`
veliaht	POST-NOUN	`veliaht`
veliyullah	POST-NOUN	`veliyullah`
vena	POST-NOUN	`vena`
venüs	POST-NOUN	`venüs`
venüsçarýðý	POST-NOUN	`venüsçarýðý`
verecek	POST-NOUN	`verecek`
verinti	POST-NOUN	`verinti`
verit	POST-NOUN	`verit`
verkaç	POST-NOUN	`verkaç`
versiyon	POST-NOUN	`versiyon`
vesaitinakliye	POST-NOUN	`vesaitinakliye`
veston	POST-NOUN	`veston`
vezaret	POST-NOUN	`vezaret`
vezikül	POST-NOUN	`vezikül`
vezin	POST-NOUN	`vezin`
vezirparmaðý	POST-NOUN	`vezirparmaðý`
výnýltý	POST-NOUN	`výnýltý`
výrýltý	POST-NOUN	`výrýltý`
vibrasyon	POST-NOUN	`vibrasyon`
vibratör	POST-NOUN	`vibratör`
vibriyo	POST-NOUN	`vibriyo`
vidanjör	POST-NOUN	`vidanjör`
videobant	POST-NOUN	`videobant`
videokaset	POST-NOUN	`videokaset`
vido	POST-NOUN	`vido`
vinterizasyon	POST-NOUN	`vinterizasyon`
vinterize	POST-NOUN	`vinterize`
vinyet	POST-NOUN	`vinyet`
virdizeban	POST-NOUN	`virdizeban`
vire	POST-NOUN	`vire`
virman	POST-NOUN	`virman`
virolog	POST-NOUN	`virolog`
viroloji	POST-NOUN	`viroloji`
virt	POST-NOUN	`virt`
visal	POST-NOUN	`visal`
visamiral	POST-NOUN	`visamiral`
viskonsül	POST-NOUN	`viskonsül`
viskoz	POST-NOUN	`viskoz`
viskozite	POST-NOUN	`viskozite`
viþnap	POST-NOUN	`viþnap`
viþneçürüðü	POST-NOUN	`viþneçürüðü`
vitir	POST-NOUN	`vitir`
viya	POST-NOUN	`viya`
viyol	POST-NOUN	`viyol`
viziyer	POST-NOUN	`viziyer`
vizör	POST-NOUN	`vizör`
vizyon	POST-NOUN	`vizyon`
vokal	POST-NOUN	`vokal`
vokal	POST-NOUN	`vokal`
vokalist	POST-NOUN	`vokalist`
voltametre	POST-NOUN	`voltametre`
voltmetre	POST-NOUN	`voltmetre`
vombat	POST-NOUN	`vombat`
vulva	POST-NOUN	`vulva`
vuraç	POST-NOUN	`vuraç`
vuruntu	POST-NOUN	`vuruntu`
vusul	POST-NOUN	`vusul`
vücut	POST-NOUN	`vücut`
vürut	POST-NOUN	`vürut`
vüsat	POST-NOUN	`vüsat`
vüzera	POST-NOUN	`vüzera`
yabgu	POST-NOUN	`yabgu`
yad	POST-NOUN	`yad`
yaðar	POST-NOUN	`yaðar`
yaðýltý	POST-NOUN	`yaðýltý`
yaðölçer	POST-NOUN	`yaðölçer`
yaðrýn	POST-NOUN	`yaðrýn`
yak	POST-NOUN	`yak`
yakacak	POST-NOUN	`yakacak`
yakaza	POST-NOUN	`yakaza`
yakým	POST-NOUN	`yakým`
yakýn	POST-NOUN	`yakýn`
yakýntý	POST-NOUN	`yakýntý`
yakin	POST-NOUN	`yakin`
yalavaç	POST-NOUN	`yalavaç`
yalýçapkýný	POST-NOUN	`yalýçapkýný`
yalpý	POST-NOUN	`yalpý`
yan	POST-NOUN	`yan`
yankýlaným	POST-NOUN	`yankýlaným`
yapak	POST-NOUN	`yapak`
yapboz	POST-NOUN	`yapboz`
yapýmevi	POST-NOUN	`yapýmevi`
yaprakçýk	POST-NOUN	`yaprakçýk`
yaprakkurusu	POST-NOUN	`yaprakkurusu`
yaradan	POST-NOUN	`yaradan`
yaran	POST-NOUN	`yaran`
yarenbaþý	POST-NOUN	`yarenbaþý`
yargýevi	POST-NOUN	`yargýevi`
yarý	POST-NOUN	`yarý`
yarým	POST-NOUN	`yarým`
yarýntý	POST-NOUN	`yarýntý`
yarýþým	POST-NOUN	`yarýþým`
yarka	POST-NOUN	`yarka`
yarüaðyar	POST-NOUN	`yarüaðyar`
yasin	POST-NOUN	`yasin`
yaþ	POST-NOUN	`yaþ`
yaþ	POST-NOUN	`yaþ`
yatým	POST-NOUN	`yatým`
yatýr	POST-NOUN	`yatýr`
yavru	POST-NOUN	`yavru`
yavruaðzý	POST-NOUN	`yavruaðzý`
yavrucaðýz	POST-NOUN	`yavrucaðýz`
yavrucuk	POST-NOUN	`yavrucuk`
yavrukurt	POST-NOUN	`yavrukurt`
yayçizer	POST-NOUN	`yayçizer`
yayýnevi	POST-NOUN	`yayýnevi`
yayýným	POST-NOUN	`yayýným`
yayýnispi	POST-NOUN	`yayýnispi`
yayýntý	POST-NOUN	`yayýntý`
yaylakiye	POST-NOUN	`yaylakiye`
yazdýrmak	POST-NOUN	`yazdýrmak`
yazýla	POST-NOUN	`yazýla`
yazýr	POST-NOUN	`yazýr`
yedi	POST-NOUN	`yedi`
yedialtmýþbeþ	POST-NOUN	`yedialtmýþbeþ`
yedigir	POST-NOUN	`yedigir`
yedikardeþ	POST-NOUN	`yedikardeþ`
yekvücut	POST-NOUN	`yekvücut`
yelin	POST-NOUN	`yelin`
yelkýran	POST-NOUN	`yelkýran`
yelölçer	POST-NOUN	`yelölçer`
yemekaltý	POST-NOUN	`yemekaltý`
yemen	POST-NOUN	`yemen`
yemiþen	POST-NOUN	`yemiþen`
yengen	POST-NOUN	`yengen`
yerdegezen	POST-NOUN	`yerdegezen`
yeregeçen	POST-NOUN	`yeregeçen`
yereþeði	POST-NOUN	`yereþeði`
yerleþke	POST-NOUN	`yerleþke`
yeryüzü	POST-NOUN	`yeryüzü`
yeþil	POST-NOUN	`yeþil`
yeþilbiber	POST-NOUN	`yeþilbiber`
yeþilçekirge	POST-NOUN	`yeþilçekirge`
yeþilfasulye	POST-NOUN	`yeþilfasulye`
yeþilimtýrak	POST-NOUN	`yeþilimtýrak`
yeþilkertenkele	POST-NOUN	`yeþilkertenkele`
yeþilsazan	POST-NOUN	`yeþilsazan`
yetiþek	POST-NOUN	`yetiþek`
yetiþim	POST-NOUN	`yetiþim`
yeygi	POST-NOUN	`yeygi`
yezidi	POST-NOUN	`yezidi`
yezit	POST-NOUN	`yezit`
yýðýþým	POST-NOUN	`yýðýþým`
yýkamaç	POST-NOUN	`yýkamaç`
yýlanbaþý	POST-NOUN	`yýlanbaþý`
yýlankemiði	POST-NOUN	`yýlankemiði`
yýlanyastýðý	POST-NOUN	`yýlanyastýðý`
yýlbaþý	POST-NOUN	`yýlbaþý`
yýrtým	POST-NOUN	`yýrtým`
yýva	POST-NOUN	`yýva`
yiðit	POST-NOUN	`yiðit`
yiðitbaþý	POST-NOUN	`yiðitbaþý`
yirik	POST-NOUN	`yirik`
yirmi	POST-NOUN	`yirmi`
yiyim	POST-NOUN	`yiyim`
yoð	POST-NOUN	`yoð`
yoðrum	POST-NOUN	`yoðrum`
yoðunlaç	POST-NOUN	`yoðunlaç`
yoðurt	POST-NOUN	`yoðurt`
yoðurthane	POST-NOUN	`yoðurthane`
yoðurum	POST-NOUN	`yoðurum`
yok	POST-NOUN	`yok`
yokoðluyok	POST-NOUN	`yokoðluyok`
yolkesen	POST-NOUN	`yolkesen`
yönbul	POST-NOUN	`yönbul`
yönetiþim	POST-NOUN	`yönetiþim`
yörük	POST-NOUN	`yörük`
yugoslav	POST-NOUN	`yugoslav`
yumrucuk	POST-NOUN	`yumrucuk`
yumurtakökü	POST-NOUN	`yumurtakökü`
yumuþaklaþmak	POST-NOUN	`yumuþaklaþmak`
yunan	POST-NOUN	`yunan`
yurdu	POST-NOUN	`yurdu`
yurt	POST-NOUN	`yurt`
yuvarlak	POST-NOUN	`yuvarlak`
yük	POST-NOUN	`yük`
yükçeker	POST-NOUN	`yükçeker`
yüksek	POST-NOUN	`yüksek`
yükseklikölçer	POST-NOUN	`yükseklikölçer`
yükün	POST-NOUN	`yükün`
yün	POST-NOUN	`yün`
yüregir	POST-NOUN	`yüregir`
yüzgöz	POST-NOUN	`yüzgöz`
yüzsuyu	POST-NOUN	`yüzsuyu`
zabýt	POST-NOUN	`zabýt`
zabitan	POST-NOUN	`zabitan`
zaç	POST-NOUN	`zaç`
zafran	POST-NOUN	`zafran`
zaðanos	POST-NOUN	`zaðanos`
zahter	POST-NOUN	`zahter`
zait	POST-NOUN	`zait`
zamk	POST-NOUN	`zamk`
zamkýarabi	POST-NOUN	`zamkýarabi`
zamkinos	POST-NOUN	`zamkinos`
zangýrtý	POST-NOUN	`zangýrtý`
zaping	POST-NOUN	`zaping`
zatýalileri	POST-NOUN	`zatýalileri`
zatýaliniz	POST-NOUN	`zatýaliniz`
zatülcenp	POST-NOUN	`zatülcenp`
zatürre	POST-NOUN	`zatürre`
zeban	POST-NOUN	`zeban`
zebercet	POST-NOUN	`zebercet`
zecir	POST-NOUN	`zecir`
zehap	POST-NOUN	`zehap`
zehir	POST-NOUN	`zehir`
zelber	POST-NOUN	`zelber`
zen	POST-NOUN	`zen`
zencir	POST-NOUN	`zencir`
zencirek	POST-NOUN	`zencirek`
zer	POST-NOUN	`zer`
zeravent	POST-NOUN	`zeravent`
zerk	POST-NOUN	`zerk`
zerrin	POST-NOUN	`zerrin`
zeval	POST-NOUN	`zeval`
zeveban	POST-NOUN	`zeveban`
zevk	POST-NOUN	`zevk`
zevkiselim	POST-NOUN	`zevkiselim`
zevküsefa	POST-NOUN	`zevküsefa`
zeyil	POST-NOUN	`zeyil`
zeytin	POST-NOUN	`zeytin`
zeytinyaðý	POST-NOUN	`zeytinyaðý`
zýnk	POST-NOUN	`zýnk`
zifin	POST-NOUN	`zifin`
zigon	POST-NOUN	`zigon`
zihin	POST-NOUN	`zihin`
zihniye	POST-NOUN	`zihniye`
zikir	POST-NOUN	`zikir`
zilyet	POST-NOUN	`zilyet`
zimmi	POST-NOUN	`zimmi`
zindandelen	POST-NOUN	`zindandelen`
zir	POST-NOUN	`zir`
ziraat	POST-NOUN	`ziraat`
zirkon	POST-NOUN	`zirkon`
zloti	POST-NOUN	`zloti`
zodyak	POST-NOUN	`zodyak`
zonk	POST-NOUN	`zonk`
zoolog	POST-NOUN	`zoolog`
zooloji	POST-NOUN	`zooloji`
zootekni	POST-NOUN	`zootekni`
zor	POST-NOUN	`zor`
zorgu	POST-NOUN	`zorgu`
zulüm	POST-NOUN	`zulüm`
zurnazen	POST-NOUN	`zurnazen`
zübde	POST-NOUN	`zübde`
zühal	POST-NOUN	`zühal`
zühre	POST-NOUN	`zühre`
züht	POST-NOUN	`züht`
zülal	POST-NOUN	`zülal`
zülcelal	POST-NOUN	`zülcelal`
zülfaruz	POST-NOUN	`zülfaruz`
zülfikar	POST-NOUN	`zülfikar`
zülfüyar	POST-NOUN	`zülfüyar`
zülüf	POST-NOUN	`zülüf`
zümrüdi	POST-NOUN	`zümrüdi`
zümrüdüanka	POST-NOUN	`zümrüdüanka`
zümrüt	POST-NOUN	`zümrüt`
zürefa	POST-NOUN	`zürefa`
